Timestamp,Open,High,Low,Close,Volume,VWAP,Type,Range
16-04-2024 09:45,45,46,41,42,274,48.96619865,Sell,5
16-04-2024 09:30,48,48,45,45,177,49.82413584,Sell,3
16-04-2024 09:15,47,48,47,48,37,50.26970109,Buy,1
16-04-2024 09:00,48,48,47,47,26,50.35052265,Sell,1
16-04-2024 08:45,48,49,48,48,82,50.40951029,Sell,1
16-04-2024 08:30,51,51,49,49,134,50.55614167,Sell,2
16-04-2024 08:15,51,51,51,51,7,50.65213747,Sell,0
16-04-2024 07:45,51,51,51,51,12,50.65008432,Sell,0
16-04-2024 07:30,52,52,51,51,9,50.64650767,Sell,1
16-04-2024 07:15,54,54,52,52,17,50.63948498,Sell,2
16-04-2024 07:00,53,54,52,53,58,50.60627178,Sell,2
16-04-2024 06:45,50,52,50,52,118,50.47981651,Buy,2
16-04-2024 06:30,51,53,50,51,162,50.34259259,Sell,3
16-04-2024 04:15,52,52,50,51,113,50.24320988,Sell,2
16-04-2024 04:00,53,53,53,53,17,50.09469154,Sell,0
16-04-2024 03:45,54,55,54,54,22,50.02205882,Sell,1
16-04-2024 03:30,53,55,53,54,48,49.88145897,Buy,2
16-04-2024 03:15,52,52,52,52,6,49.55409836,Sell,0
16-04-2024 03:00,51,53,51,53,49,49.52980132,Buy,2
16-04-2024 02:45,49,52,49,51,123,49.3009009,Buy,3
16-04-2024 02:30,49,50,47,50,260,48.9837963,Buy,3
15-04-2024 15:15,49,49,49,49,4,49.12209302,Sell,0
15-04-2024 15:00,49,49,47,48,26,49.125,Sell,2
15-04-2024 14:45,49,49,49,49,7,49.30985915,Sell,0
15-04-2024 14:30,49,49,49,49,13,49.32592593,Sell,0
15-04-2024 14:00,49,49,48,49,19,49.36065574,Sell,1
15-04-2024 13:45,49,49,48,48,30,49.49514563,Sell,1
15-04-2024 13:30,49,49,49,49,1,49.90410959,Sell,0
15-04-2024 13:15,50,50,49,49,39,49.91666667,Sell,1
15-04-2024 13:00,51,51,50,50,33,50.27272727,Sell,1
15-04-2024 09:45,53,53,51,52,129,54.63898224,Sell,2
15-04-2024 09:30,53,53,52,52,162,54.82139202,Sell,1
15-04-2024 09:15,53,53,52,52,51,55.06584821,Sell,1
15-04-2024 09:00,53,54,53,53,14,55.14187249,Sell,1
15-04-2024 08:45,53,56,52,53,263,55.15865663,Sell,4
15-04-2024 08:30,53,54,52,53,27,55.29371585,Sell,2
15-04-2024 08:15,53,53,53,53,5,55.34098817,Sell,0
15-04-2024 08:00,52,54,51,53,119,55.34916201,Buy,3
15-04-2024 07:45,53,53,52,52,48,55.6092917,Sell,1
15-04-2024 07:30,54,54,52,52,80,55.7256917,Sell,2
15-04-2024 07:15,54,55,54,54,44,55.95443038,Sell,1
15-04-2024 07:00,56,56,54,54,82,56.0219106,Sell,2
15-04-2024 06:45,57,57,56,56,109,56.09442871,Sell,1
15-04-2024 06:30,55,57,54,57,289,56.05368421,Buy,3
15-04-2024 04:15,55,56,55,55,89,56.1709531,Sell,1
15-04-2024 04:00,55,56,55,55,85,56.2534965,Sell,1
15-04-2024 03:45,55,56,55,55,64,56.45790554,Sell,1
15-04-2024 03:30,55,56,55,56,72,56.55082742,Buy,1
15-04-2024 03:15,55,55,55,55,68,56.79202279,Sell,0
15-04-2024 03:00,56,57,56,57,26,57.22261484,Buy,1
15-04-2024 02:45,57,58,56,57,95,57.29182879,Sell,2
15-04-2024 02:30,57,60,55,57,162,57.35802469,Sell,5
12-04-2024 09:45,60,60,57,57,81,57.9399428,Sell,3
12-04-2024 09:30,59,60,58,60,147,57.8357438,Buy,2
12-04-2024 09:15,59,60,59,60,31,57.66869671,Buy,1
12-04-2024 09:00,59,59,59,59,19,57.60253165,Sell,0
12-04-2024 08:45,58,60,58,60,64,57.56809339,Buy,2
12-04-2024 08:30,58,59,58,58,30,57.4582744,Sell,1
12-04-2024 08:15,58,59,58,59,11,57.41063516,Buy,1
12-04-2024 08:00,56,58,56,58,51,57.39189189,Buy,2
12-04-2024 07:45,56,56,55,55,12,57.4,Sell,1
12-04-2024 07:30,56,56,55,55,7,57.44444444,Sell,1
12-04-2024 07:00,55,55,55,55,14,57.47147651,Sell,0
12-04-2024 06:45,56,57,56,56,14,57.53092784,Sell,1
12-04-2024 06:30,57,58,56,56,94,57.56514085,Sell,2
12-04-2024 04:15,57,57,57,57,9,57.59704641,Sell,0
12-04-2024 04:00,56,57,56,57,22,57.60860215,Buy,1
12-04-2024 03:45,56,56,56,56,4,57.65462754,Sell,0
12-04-2024 03:30,56,57,56,57,11,57.66970387,Buy,1
12-04-2024 03:15,56,56,55,56,11,57.69626168,Sell,1
12-04-2024 03:00,56,56,54,56,73,57.74340528,Sell,2
12-04-2024 02:45,56,57,54,57,144,58.23255814,Buy,3
12-04-2024 02:30,64,64,56,57,200,59.95,Sell,8
09-04-2024 09:45,63,63,62,63,77,62.3348654,Sell,1
09-04-2024 09:30,63,63,63,63,1,62.30359613,Sell,0
09-04-2024 09:15,64,64,63,63,19,62.30311419,Sell,1
09-04-2024 09:00,64,64,64,64,6,62.29032258,Sell,0
09-04-2024 08:30,64,64,64,64,5,62.28309859,Sell,0
09-04-2024 08:00,64,65,63,64,25,62.2770318,Sell,2
09-04-2024 07:45,64,64,64,64,4,62.24676259,Sell,0
09-04-2024 07:30,65,65,65,65,2,62.24170274,Sell,0
09-04-2024 07:15,64,65,64,65,11,62.23771676,Buy,1
09-04-2024 07:00,63,64,63,64,19,62.22286963,Buy,1
09-04-2024 06:45,65,66,63,64,160,62.20827179,Sell,3
09-04-2024 06:30,62,65,61,65,162,61.8919598,Buy,4
09-04-2024 04:15,61,62,61,62,9,61.81104651,Buy,1
09-04-2024 03:45,61,61,60,60,39,61.8113392,Sell,1
09-04-2024 03:30,62,63,61,61,96,61.84857724,Sell,2
09-04-2024 03:15,62,63,62,63,203,61.84572072,Buy,1
09-04-2024 03:00,63,64,62,62,132,61.75766423,Sell,2
09-04-2024 02:45,62,63,61,63,47,61.53887884,Buy,2
09-04-2024 02:30,61,62,59,62,248,61.51185771,Buy,3
08-04-2024 15:15,62,63,62,63,15,62.44573643,Buy,1
08-04-2024 15:00,63,63,62,63,23,62.41563786,Sell,1
08-04-2024 14:45,61,63,61,62,24,62.4,Buy,2
08-04-2024 14:30,61,62,61,61,29,62.42346939,Sell,1
08-04-2024 14:15,62,63,62,62,68,62.63473054,Sell,1
08-04-2024 14:00,63,64,62,62,57,63.05050505,Sell,2
08-04-2024 13:45,62,63,62,63,21,62.88095238,Buy,1
08-04-2024 13:30,63,63,63,63,4,63.38095238,Sell,0
08-04-2024 13:15,63,63,63,63,5,63.47058824,Sell,0
08-04-2024 13:00,64,64,63,63,12,63.66666667,Sell,1
08-04-2024 09:45,62,64,62,64,96,62.53280632,Buy,2
08-04-2024 09:30,63,63,62,62,19,62.45851155,Sell,1
08-04-2024 09:15,62,62,60,60,37,62.4626087,Sell,2
08-04-2024 09:00,62,63,62,62,5,62.50044924,Sell,1
08-04-2024 08:45,63,64,62,63,109,62.50180505,Sell,2
08-04-2024 08:30,62,62,62,62,3,62.4034034,Sell,0
08-04-2024 08:15,63,63,61,61,17,62.40461847,Sell,2
08-04-2024 08:00,62,63,62,63,22,62.40960163,Buy,1
08-04-2024 07:45,63,63,61,61,14,62.40229885,Sell,2
08-04-2024 07:30,62,63,62,63,20,62.40721103,Buy,1
08-04-2024 07:15,61,62,61,62,10,62.39653304,Buy,1
08-04-2024 07:00,61,62,61,62,15,62.40306681,Buy,1
08-04-2024 06:45,63,63,62,62,58,62.422049,Sell,1
08-04-2024 06:30,60,63,59,63,121,62.4047619,Buy,4
08-04-2024 04:15,64,64,60,60,178,62.66759388,Sell,4
08-04-2024 04:00,65,67,65,65,42,63.12569316,Sell,2
08-04-2024 03:45,63,65,62,65,115,62.93386774,Buy,3
08-04-2024 03:30,63,63,63,63,10,62.53125,Sell,0
08-04-2024 03:15,61,64,61,63,75,62.51871658,Buy,3
08-04-2024 03:00,62,63,61,62,77,62.61204013,Sell,2
08-04-2024 02:45,62,63,62,63,25,62.89189189,Buy,1
08-04-2024 02:30,64,65,60,61,197,62.93908629,Sell,5
05-04-2024 09:45,64,64,62,64,80,60.8729927,Sell,2
05-04-2024 09:30,62,64,62,64,135,60.5553719,Buy,2
05-04-2024 09:15,61,63,61,63,10,59.84680851,Buy,2
05-04-2024 09:00,62,62,62,62,2,59.80434783,Sell,0
05-04-2024 08:45,62,62,61,62,12,59.79475983,Sell,1
05-04-2024 08:30,61,62,61,61,63,59.75336323,Sell,1
05-04-2024 08:15,60,60,59,60,39,59.49869452,Sell,1
05-04-2024 08:00,61,61,59,59,27,59.49709302,Sell,2
05-04-2024 07:45,61,62,61,62,20,59.46056782,Buy,1
05-04-2024 07:30,61,61,61,61,11,59.31313131,Sell,0
05-04-2024 07:00,61,61,61,61,17,59.24825175,Sell,0
05-04-2024 06:45,58,60,58,60,29,59.13754647,Buy,2
05-04-2024 06:30,59,59,58,59,52,59.13333333,Sell,1
05-04-2024 04:15,58,58,58,58,8,59.30319149,Sell,0
05-04-2024 04:00,58,58,58,58,1,59.36111111,Sell,0
05-04-2024 03:30,57,57,57,57,3,59.36871508,Sell,0
05-04-2024 02:45,58,58,57,57,30,59.40909091,Sell,1
05-04-2024 02:30,58,58,57,57,9,59.89726027,Sell,1
04-04-2024 15:15,58,58,58,58,24,60.03649635,Sell,0
04-04-2024 15:00,58,58,58,58,4,60.46902655,Sell,0
04-04-2024 14:15,61,61,59,59,14,60.55963303,Sell,2
04-04-2024 14:00,60,61,60,60,6,60.74736842,Sell,1
04-04-2024 13:45,61,61,60,60,18,60.7752809,Sell,1
04-04-2024 13:30,60,61,60,61,15,60.92957746,Buy,1
04-04-2024 13:15,60,60,60,60,20,61.16071429,Sell,0
04-04-2024 13:00,62,63,61,61,36,61.80555556,Sell,2
04-04-2024 09:45,62,63,62,63,150,61.71458999,Buy,1
04-04-2024 09:30,62,63,61,62,132,61.66261574,Sell,2
04-04-2024 09:15,61,62,60,62,39,61.6566416,Buy,2
04-04-2024 09:00,62,62,61,61,38,61.66217084,Sell,1
04-04-2024 08:30,62,62,61,61,12,61.6642528,Sell,1
04-04-2024 08:15,61,62,61,62,70,61.66556072,Buy,1
04-04-2024 08:00,61,61,61,61,25,61.66597077,Sell,0
04-04-2024 07:45,59,61,59,60,33,61.67776204,Buy,2
04-04-2024 07:30,59,59,58,59,8,61.72081218,Sell,1
04-04-2024 07:15,59,59,59,59,24,61.73960613,Sell,0
04-04-2024 06:45,60,60,59,59,10,61.78841871,Sell,1
04-04-2024 06:30,60,60,60,60,1,61.80403889,Sell,0
04-04-2024 04:15,60,61,60,61,17,61.80538922,Buy,1
04-04-2024 04:00,61,61,60,60,21,61.82410917,Sell,1
04-04-2024 03:45,62,62,62,62,4,61.84206471,Sell,0
04-04-2024 03:30,62,63,62,62,25,61.84157651,Sell,1
04-04-2024 03:15,62,62,61,62,48,61.83372734,Sell,1
04-04-2024 03:00,63,64,60,62,212,61.85339885,Sell,4
04-04-2024 02:45,63,63,62,62,9,61.8741328,Sell,1
04-04-2024 02:30,61,63,60,63,37,61.866,Buy,3
03-04-2024 15:15,60,62,59,62,33,61.89200415,Buy,3
03-04-2024 15:00,59,60,59,60,94,61.9516129,Buy,1
03-04-2024 14:45,61,61,59,60,60,62.21291866,Sell,2
03-04-2024 14:30,61,63,60,61,166,62.375,Sell,3
03-04-2024 14:15,63,64,61,61,287,62.87377049,Sell,3
03-04-2024 14:00,63,64,63,63,112,63.69659443,Sell,1
03-04-2024 13:45,65,65,64,64,12,63.96682464,Sell,1
03-04-2024 13:30,65,65,65,65,1,63.95979899,Sell,0
03-04-2024 13:15,64,64,63,64,15,63.95454545,Sell,1
03-04-2024 13:00,65,65,63,63,183,63.9726776,Sell,2
03-04-2024 09:45,68,69,66,66,190,68.38967972,Sell,3
03-04-2024 09:30,70,70,67,67,77,68.49923664,Sell,3
03-04-2024 09:15,71,72,70,71,47,68.4978372,Sell,2
03-04-2024 09:00,70,71,70,71,59,68.45512821,Buy,1
03-04-2024 08:45,67,71,67,71,117,68.39556832,Buy,4
03-04-2024 08:30,66,67,66,67,11,68.34008621,Buy,1
03-04-2024 08:15,68,68,67,67,16,68.34993504,Sell,1
03-04-2024 08:00,66,68,65,68,119,68.35368513,Buy,3
03-04-2024 07:45,66,67,66,66,106,68.47838086,Sell,1
03-04-2024 07:30,66,67,66,66,183,68.60203095,Sell,1
03-04-2024 07:15,68,68,65,66,270,68.83023873,Sell,3
03-04-2024 07:00,69,69,67,68,130,69.24582043,Sell,2
03-04-2024 06:45,69,71,68,68,350,69.36565657,Sell,3
03-04-2024 06:30,70,70,68,68,184,69.44405286,Sell,2
03-04-2024 04:15,67,69,67,69,101,69.54363828,Buy,2
03-04-2024 04:00,68,68,68,68,17,69.74352941,Sell,0
03-04-2024 03:45,69,69,68,68,37,69.77911164,Sell,1
03-04-2024 03:30,69,70,69,70,23,69.84798995,Buy,1
03-04-2024 03:15,70,71,68,70,131,69.85769728,Sell,3
03-04-2024 03:00,70,73,70,70,141,69.894081,Sell,3
03-04-2024 02:45,69,70,69,70,28,69.53892216,Buy,1
03-04-2024 02:30,71,73,68,68,148,69.56659619,Sell,5
02-04-2024 15:15,72,72,71,71,13,69.06461538,Sell,1
02-04-2024 14:45,71,71,70,71,7,68.96153846,Sell,1
02-04-2024 14:30,71,72,70,70,12,68.92459016,Sell,2
02-04-2024 14:15,70,71,70,71,28,68.85324232,Buy,1
02-04-2024 14:00,70,70,68,68,9,68.69056604,Sell,2
02-04-2024 13:45,71,71,69,69,21,68.6875,Sell,2
02-04-2024 13:30,68,71,68,71,106,68.56170213,Buy,3
02-04-2024 13:15,66,69,66,69,108,67.41860465,Buy,3
02-04-2024 13:00,66,66,65,66,21,65.23809524,Sell,1
02-04-2024 09:45,63,66,63,65,144,63.42697595,Buy,3
02-04-2024 09:30,62,63,62,63,25,63.32058824,Buy,1
02-04-2024 09:15,64,65,60,62,309,63.34673367,Sell,5
02-04-2024 09:00,64,64,64,64,4,64.12973761,Sell,0
02-04-2024 08:45,63,65,63,64,69,64.13049853,Buy,2
02-04-2024 08:30,63,63,63,63,5,64.14845024,Sell,0
02-04-2024 08:15,63,63,63,63,3,64.15789474,Sell,0
02-04-2024 07:30,63,63,63,63,91,64.16363636,Sell,0
02-04-2024 07:15,63,63,63,63,20,64.36964981,Sell,0
02-04-2024 07:00,64,65,64,64,74,64.42510121,Sell,1
02-04-2024 06:45,62,63,62,63,27,64.41666667,Buy,1
02-04-2024 06:30,61,62,61,61,17,64.54198473,Sell,1
02-04-2024 04:15,62,62,62,62,10,64.69148936,Sell,0
02-04-2024 04:00,63,63,63,63,2,64.76502732,Sell,0
02-04-2024 03:45,63,63,63,63,20,64.77472527,Sell,0
02-04-2024 03:30,64,64,63,63,23,64.87790698,Sell,1
02-04-2024 03:15,65,66,65,65,202,64.95327103,Sell,1
02-04-2024 03:00,64,65,64,65,27,63.82352941,Buy,1
02-04-2024 02:45,63,65,63,65,22,63.48913043,Buy,2
02-04-2024 02:30,63,64,63,64,18,63.35714286,Buy,1
01-04-2024 15:15,62,64,62,64,21,63.30769231,Buy,2
01-04-2024 15:00,63,63,63,63,6,63.48387097,Sell,0
01-04-2024 14:45,64,64,64,64,3,63.6,Sell,0
01-04-2024 14:00,63,63,63,63,1,63.54545455,Sell,0
01-04-2024 13:45,63,64,63,64,2,63.57142857,Buy,1
01-04-2024 13:15,64,64,63,63,12,63.57894737,Sell,1
01-04-2024 13:00,64,64,64,64,7,64,Sell,0
01-04-2024 09:45,65,65,64,64,21,63.47129909,Sell,1
01-04-2024 09:30,63,65,63,65,140,63.45356869,Buy,2
01-04-2024 09:15,62,62,62,62,58,63.34651763,Sell,0
01-04-2024 09:00,62,62,62,62,3,63.41719457,Sell,0
01-04-2024 08:30,62,62,62,62,44,63.42105263,Sell,0
01-04-2024 08:15,61,62,61,62,95,63.48015123,Buy,1
01-04-2024 08:00,63,63,61,62,123,63.64589823,Sell,2
01-04-2024 07:45,64,64,62,62,38,63.9,Sell,2
01-04-2024 07:30,64,64,63,63,75,63.96508728,Sell,1
01-04-2024 07:15,64,64,63,64,55,64.03301238,Sell,1
01-04-2024 07:00,64,64,63,64,50,64.03720238,Sell,1
01-04-2024 06:45,63,64,63,64,33,64.11575563,Buy,1
01-04-2024 06:30,66,67,62,63,165,64.14431239,Sell,5
01-04-2024 04:15,66,66,65,65,45,63.70754717,Sell,1
01-04-2024 04:00,66,66,66,66,3,63.49868074,Sell,0
01-04-2024 03:30,65,66,65,66,10,63.4787234,Buy,1
01-04-2024 03:15,66,66,65,65,8,63.41256831,Sell,1
01-04-2024 03:00,67,67,66,66,17,63.36312849,Sell,1
01-04-2024 02:45,66,68,65,67,93,63.228739,Buy,3
01-04-2024 02:30,58,65,58,65,248,61.97580645,Buy,7
29-03-2024 09:45,57,58,55,58,56,56.0576,Buy,3
29-03-2024 09:30,56,56,56,56,10,55.98769772,Sell,0
29-03-2024 09:15,56,56,56,56,12,55.98747764,Sell,0
29-03-2024 09:00,56,56,56,56,1,55.98720293,Sell,0
29-03-2024 08:15,56,56,56,56,42,55.98717949,Sell,0
29-03-2024 07:30,56,56,56,56,4,55.98611111,Sell,0
29-03-2024 07:15,56,56,56,56,2,55.986,Sell,0
29-03-2024 07:00,56,57,55,55,22,55.98594378,Sell,2
29-03-2024 06:45,55,57,55,56,12,55.98529412,Buy,2
29-03-2024 06:30,56,57,56,57,9,55.98275862,Buy,1
29-03-2024 04:15,55,55,55,55,23,55.97582418,Sell,0
29-03-2024 04:00,54,54,54,54,2,56.02777778,Sell,0
29-03-2024 03:30,53,54,53,54,19,56.0372093,Buy,1
29-03-2024 03:15,56,56,51,52,212,56.14841849,Sell,5
29-03-2024 03:00,57,58,56,56,59,58.40703518,Sell,2
29-03-2024 02:45,59,59,57,58,57,59.00714286,Sell,2
29-03-2024 02:30,58,62,58,58,83,59.6746988,Sell,4
27-03-2024 09:45,62,63,61,62,52,63.09713024,Sell,2
27-03-2024 09:30,62,62,62,62,10,63.17213115,Sell,0
27-03-2024 09:15,63,63,62,62,54,63.18601896,Sell,1
27-03-2024 09:00,62,63,62,63,7,63.24556962,Buy,1
27-03-2024 08:45,64,64,63,63,43,63.25287356,Sell,1
27-03-2024 08:30,64,64,63,63,51,63.25810811,Sell,1
27-03-2024 08:15,64,64,64,64,4,63.25544267,Sell,0
27-03-2024 08:00,64,64,64,64,20,63.25109489,Sell,0
27-03-2024 07:45,64,64,64,64,5,63.22857143,Sell,0
27-03-2024 07:30,63,64,63,64,25,63.22272727,Buy,1
27-03-2024 07:15,63,63,63,63,16,63.21889764,Sell,0
27-03-2024 06:45,64,64,63,63,11,63.22455574,Sell,1
27-03-2024 06:30,64,64,63,63,54,63.21381579,Sell,1
27-03-2024 04:15,65,65,64,64,22,63.19855596,Sell,1
27-03-2024 04:00,64,65,64,65,19,63.15601504,Buy,1
27-03-2024 03:45,64,64,63,64,7,63.1208577,Sell,1
27-03-2024 03:30,64,64,64,64,11,63.11857708,Sell,0
27-03-2024 03:15,61,63,60,63,28,63.0989899,Buy,3
27-03-2024 03:00,62,62,60,61,72,63.16916488,Sell,2
27-03-2024 02:45,63,64,61,62,214,63.47848101,Sell,3
27-03-2024 02:30,65,65,63,63,54,64.5801105,Sell,2
26-03-2024 15:15,64,64,64,64,14,65.23622047,Sell,0
26-03-2024 15:00,65,65,64,64,2,65.38938053,Sell,1
26-03-2024 14:45,65,65,64,64,3,65.40540541,Sell,1
26-03-2024 14:30,64,64,64,64,10,65.42592593,Sell,0
26-03-2024 14:15,65,65,65,65,1,65.57142857,Sell,0
26-03-2024 13:30,65,65,65,65,15,65.57731959,Sell,0
26-03-2024 13:15,67,67,65,65,70,65.68292683,Sell,2
26-03-2024 13:00,66,67,66,67,12,66.75,Buy,1
26-03-2024 09:45,67,67,67,67,1,67.79166667,Sell,0
26-03-2024 09:00,67,67,67,67,4,67.79331942,Sell,0
26-03-2024 08:45,67,67,67,67,2,67.8,Sell,0
26-03-2024 08:30,68,68,68,68,1,67.80338266,Sell,0
26-03-2024 08:15,67,67,67,67,31,67.8029661,Sell,0
26-03-2024 08:00,68,68,67,67,7,67.85941043,Sell,1
26-03-2024 07:45,68,68,67,68,16,67.8640553,Sell,1
26-03-2024 07:30,67,67,67,67,1,67.86363636,Sell,0
26-03-2024 07:15,67,67,67,67,9,67.86570743,Sell,0
26-03-2024 06:45,68,68,68,68,10,67.88480392,Sell,0
26-03-2024 06:30,67,68,66,67,14,67.88190955,Sell,2
26-03-2024 04:15,68,68,68,68,17,67.91927083,Sell,0
26-03-2024 04:00,67,68,67,68,26,67.91553134,Buy,1
26-03-2024 03:45,67,67,66,67,27,67.94134897,Sell,1
26-03-2024 03:30,68,69,67,67,26,68.07006369,Sell,2
26-03-2024 03:15,67,67,67,67,2,68.11111111,Sell,0
26-03-2024 03:00,67,67,67,67,3,68.11888112,Sell,0
26-03-2024 02:45,68,68,68,68,14,68.13074205,Sell,0
26-03-2024 02:30,69,69,68,69,15,68.13754647,Sell,1
25-03-2024 15:15,67,69,67,69,18,68.09448819,Buy,2
25-03-2024 15:00,68,68,67,68,11,68.12711864,Sell,1
25-03-2024 14:00,69,69,69,69,6,68.13777778,Sell,0
25-03-2024 13:45,68,68,68,68,5,68.11415525,Sell,0
25-03-2024 13:30,69,69,68,68,11,68.11682243,Sell,1
25-03-2024 13:15,67,70,67,69,135,68.07881773,Buy,3
25-03-2024 13:00,68,69,65,65,68,66.66176471,Sell,4
25-03-2024 09:45,70,71,68,68,129,65.73254364,Sell,3
25-03-2024 09:30,71,71,70,70,5,65.43661017,Sell,1
25-03-2024 09:15,70,70,70,70,1,65.41836735,Sell,0
25-03-2024 09:00,71,71,70,70,11,65.41524847,Sell,1
25-03-2024 08:45,71,72,70,71,45,65.37722908,Sell,2
25-03-2024 08:30,71,72,71,71,40,65.1960368,Sell,1
25-03-2024 08:15,66,72,66,72,270,65.01310998,Buy,6
25-03-2024 08:00,66,67,66,67,39,64.11786038,Buy,1
25-03-2024 07:45,66,66,65,66,7,64.03853383,Sell,1
25-03-2024 07:30,65,66,64,66,48,64.02932829,Buy,2
25-03-2024 07:15,65,65,65,65,10,63.98315164,Sell,0
25-03-2024 07:00,64,66,64,65,85,63.97297297,Buy,2
25-03-2024 06:45,65,65,65,65,41,63.86214442,Sell,0
25-03-2024 06:30,64,65,63,65,110,63.80870561,Buy,2
25-03-2024 04:15,64,64,63,64,35,63.75884666,Sell,1
25-03-2024 04:00,64,65,64,65,16,63.74862637,Buy,1
25-03-2024 03:45,63,64,63,64,8,63.73455056,Buy,1
25-03-2024 03:30,64,65,63,63,165,63.73721591,Sell,2
25-03-2024 03:15,65,65,62,65,223,63.76808905,Sell,3
25-03-2024 03:00,64,64,62,64,224,63.64240506,Sell,2
25-03-2024 02:45,65,66,65,65,29,64.75,Sell,1
25-03-2024 02:30,67,68,63,65,63,64.53968254,Sell,5
22-03-2024 09:45,67,67,65,67,30,68.58747994,Sell,2
22-03-2024 09:30,66,66,66,66,8,68.64720395,Sell,0
22-03-2024 09:15,66,66,66,66,1,68.6647351,Sell,0
22-03-2024 09:00,64,64,64,64,9,68.66694283,Sell,0
22-03-2024 08:45,65,66,64,64,33,68.70200334,Sell,2
22-03-2024 08:30,66,66,66,66,4,68.82832618,Sell,0
22-03-2024 08:15,66,67,66,67,9,68.83807063,Buy,1
22-03-2024 08:00,66,67,65,67,68,68.85416667,Buy,2
22-03-2024 07:45,66,67,66,67,16,69.04520295,Buy,1
22-03-2024 07:30,67,68,66,66,27,69.07771536,Sell,2
22-03-2024 07:15,68,68,67,67,25,69.14024976,Sell,1
22-03-2024 07:00,67,67,67,67,1,69.18897638,Sell,0
22-03-2024 06:45,66,67,64,66,63,69.191133,Sell,3
22-03-2024 06:30,70,70,65,65,178,69.44327731,Sell,5
22-03-2024 04:15,71,71,71,71,20,70.06459948,Sell,0
22-03-2024 04:00,71,71,70,71,29,70.0397878,Sell,1
22-03-2024 03:45,69,70,69,70,9,70.01517241,Buy,1
22-03-2024 03:15,71,71,68,68,27,70.01675978,Sell,3
22-03-2024 03:00,70,71,70,71,35,70.0682148,Buy,1
22-03-2024 02:45,68,70,68,70,25,70.03669725,Buy,2
22-03-2024 02:30,70,71,67,67,236,70.08903021,Sell,4
21-03-2024 15:15,71,72,71,72,5,70.86259542,Buy,1
21-03-2024 15:00,70,71,70,71,5,70.8556701,Buy,1
21-03-2024 14:45,71,71,70,70,117,70.85900783,Sell,1
21-03-2024 14:30,71,72,71,72,5,71.03383459,Buy,1
21-03-2024 14:15,71,71,71,71,1,71.03065134,Sell,0
21-03-2024 14:00,71,71,71,71,5,71.03076923,Sell,0
21-03-2024 13:30,71,72,71,72,12,71.03137255,Buy,1
21-03-2024 13:15,71,72,70,72,114,71.00411523,Buy,2
21-03-2024 13:00,74,74,70,70,129,71.13953488,Sell,4
21-03-2024 09:45,72,75,71,74,597,71.84529772,Buy,4
21-03-2024 09:30,72,73,72,73,53,71.5975,Buy,1
21-03-2024 09:15,72,72,72,72,2,71.57541412,Sell,0
21-03-2024 09:00,72,72,72,72,1,71.57467249,Sell,0
21-03-2024 08:45,72,72,72,72,6,71.5743007,Sell,0
21-03-2024 08:30,72,72,72,72,5,71.57205624,Sell,0
21-03-2024 08:15,71,71,71,71,19,71.5701677,Sell,0
21-03-2024 08:00,71,71,71,71,7,71.57989228,Sell,0
21-03-2024 07:45,71,71,71,71,15,71.58355917,Sell,0
21-03-2024 07:30,71,71,71,71,5,71.59157509,Sell,0
21-03-2024 07:15,70,71,70,70,12,71.59429623,Sell,1
21-03-2024 07:00,71,71,71,71,9,71.61116279,Sell,0
21-03-2024 06:45,71,72,71,71,59,71.6163227,Sell,1
21-03-2024 06:30,73,74,70,70,513,71.64051639,Sell,4
21-03-2024 04:15,73,73,72,72,8,71.64574899,Sell,1
21-03-2024 04:00,73,73,73,73,2,71.63374486,Sell,0
21-03-2024 03:45,73,73,72,73,16,71.62809917,Sell,1
21-03-2024 03:15,72,72,72,72,19,71.58547009,Sell,0
21-03-2024 03:00,71,72,71,72,23,71.56792873,Buy,1
21-03-2024 02:45,70,73,70,72,81,71.57276995,Buy,3
21-03-2024 02:30,71,71,70,70,84,71.43188406,Sell,1
20-03-2024 15:15,73,73,72,72,13,71.86590038,Sell,1
20-03-2024 15:00,74,74,73,73,3,71.85483871,Sell,1
20-03-2024 14:45,74,74,72,73,77,71.83673469,Sell,2
20-03-2024 14:30,73,74,73,74,27,71.05952381,Buy,1
20-03-2024 14:15,72,72,71,72,22,70.60992908,Sell,1
20-03-2024 14:00,71,71,71,71,1,70.40336134,Sell,0
20-03-2024 13:45,71,71,71,71,1,70.39830508,Sell,0
20-03-2024 13:15,70,71,69,71,42,70.39316239,Buy,2
20-03-2024 13:00,72,73,69,70,75,70.57333333,Sell,4
20-03-2024 09:45,70,73,70,71,113,67.12563957,Buy,3
20-03-2024 09:30,70,72,70,71,146,66.83232078,Buy,2
20-03-2024 09:15,69,69,69,69,64,66.45933333,Sell,0
20-03-2024 09:00,68,68,68,68,26,66.34610028,Sell,0
20-03-2024 08:45,68,68,66,68,120,66.31560284,Sell,2
20-03-2024 08:30,68,68,68,68,48,66.28527132,Sell,0
20-03-2024 08:15,68,68,68,68,6,66.21900161,Sell,0
20-03-2024 08:00,70,70,68,70,12,66.21035599,Sell,2
20-03-2024 07:45,67,70,66,69,146,66.18382353,Buy,4
20-03-2024 07:30,68,69,68,68,38,66.10018553,Sell,1
20-03-2024 07:15,70,70,69,69,121,66.02980769,Sell,1
20-03-2024 07:00,71,71,70,71,56,65.52774755,Sell,1
20-03-2024 06:45,70,71,70,71,32,65.21900348,Buy,1
20-03-2024 06:30,68,71,68,71,99,65.02888087,Buy,3
20-03-2024 04:15,67,67,67,67,22,64.46857923,Sell,0
20-03-2024 04:00,68,68,66,67,46,64.39014085,Sell,2
20-03-2024 03:45,67,67,67,67,12,64.20331325,Sell,0
20-03-2024 03:30,67,67,65,67,54,64.15184049,Sell,2
20-03-2024 03:15,65,67,64,67,119,63.97324415,Buy,3
20-03-2024 03:00,63,65,62,65,79,63.60751566,Buy,3
20-03-2024 02:45,63,64,62,62,141,63.6025,Sell,2
20-03-2024 02:30,65,66,63,63,87,64.2007722,Sell,3
19-03-2024 15:15,65,66,65,65,5,64.03488372,Sell,1
19-03-2024 15:00,66,66,66,66,5,63.99401198,Sell,0
19-03-2024 14:45,64,66,64,66,86,63.93209877,Buy,2
19-03-2024 14:30,63,64,63,64,5,62.89473684,Buy,1
19-03-2024 14:15,62,63,62,63,36,62.87323944,Buy,1
19-03-2024 14:00,62,62,62,62,7,62.8,Sell,0
19-03-2024 13:45,63,63,63,63,7,63,Sell,0
19-03-2024 13:30,63,63,63,63,18,63,Sell,0
19-03-2024 13:00,63,63,63,63,3,63,Sell,0
19-03-2024 09:45,63,63,62,62,151,64.39622642,Sell,1
19-03-2024 09:30,62,63,62,63,8,64.59296875,Buy,1
19-03-2024 09:15,63,63,63,63,66,64.60849057,Sell,0
19-03-2024 09:00,63,63,62,62,21,64.69651741,Sell,1
19-03-2024 08:45,63,63,62,63,113,64.74261603,Sell,1
19-03-2024 08:30,64,64,64,64,9,64.93283582,Sell,0
19-03-2024 08:15,65,65,64,64,16,64.94073377,Sell,1
19-03-2024 08:00,64,65,64,65,47,64.95319962,Buy,1
19-03-2024 07:45,64,64,64,64,37,64.977,Sell,0
19-03-2024 07:30,62,65,62,64,225,65.0145379,Buy,3
19-03-2024 07:15,63,63,63,63,19,65.33062331,Sell,0
19-03-2024 07:00,63,63,62,62,10,65.3922114,Sell,1
19-03-2024 06:45,63,64,62,63,34,65.42877292,Sell,2
19-03-2024 06:30,64,64,62,63,19,65.52888889,Sell,2
19-03-2024 04:15,64,64,63,63,4,65.60060976,Sell,1
19-03-2024 04:00,65,65,65,65,2,65.61349693,Sell,0
19-03-2024 03:45,64,65,64,65,82,65.61538462,Buy,1
19-03-2024 03:30,63,65,63,65,11,65.70950704,Buy,2
19-03-2024 03:15,63,64,62,64,22,65.7432675,Buy,2
19-03-2024 03:00,61,63,61,62,36,65.85233645,Buy,2
19-03-2024 02:45,64,64,60,61,112,66.14228457,Sell,4
19-03-2024 02:30,66,68,63,63,83,67.37209302,Sell,5
18-03-2024 15:15,66,66,65,65,15,68.07565789,Sell,1
18-03-2024 15:00,67,68,65,66,57,68.19377163,Sell,3
18-03-2024 14:45,67,67,66,66,31,68.52155172,Sell,1
18-03-2024 14:30,67,67,67,67,3,68.86069652,Sell,0
18-03-2024 14:15,68,68,67,67,50,68.88888889,Sell,1
18-03-2024 14:00,68,68,67,68,14,69.25675676,Sell,1
18-03-2024 13:45,70,70,67,67,30,69.39552239,Sell,3
18-03-2024 13:30,70,71,69,69,57,69.65384615,Sell,2
18-03-2024 13:15,69,70,69,70,28,69.0212766,Buy,1
18-03-2024 13:00,67,69,67,68,19,68.26315789,Buy,2
18-03-2024 09:45,68,68,67,67,27,71.06695652,Sell,1
18-03-2024 09:30,70,71,69,69,34,71.14870882,Sell,2
18-03-2024 09:15,69,70,69,70,5,71.1707989,Buy,1
18-03-2024 09:00,70,70,69,69,19,71.17712177,Sell,1
18-03-2024 08:45,71,71,69,69,14,71.2084507,Sell,2
18-03-2024 08:30,71,71,69,71,93,71.22359657,Sell,2
18-03-2024 08:15,72,72,71,71,22,71.32150313,Sell,1
18-03-2024 08:00,71,73,71,72,156,71.30982906,Buy,2
18-03-2024 07:45,70,73,70,73,52,71.3,Buy,3
18-03-2024 07:30,71,71,71,71,3,71.26923077,Sell,0
18-03-2024 07:15,71,71,71,71,5,71.27034483,Sell,0
18-03-2024 07:00,70,72,70,72,17,71.27222222,Buy,2
18-03-2024 06:45,71,72,68,69,65,71.27880512,Sell,4
18-03-2024 06:30,72,72,70,70,41,71.43887147,Sell,2
18-03-2024 04:15,73,74,73,73,16,71.4438861,Sell,1
18-03-2024 03:45,74,75,73,74,24,71.39931153,Sell,2
18-03-2024 03:30,72,74,72,74,132,71.27827648,Buy,2
18-03-2024 03:15,71,72,68,71,125,70.71529412,Sell,4
18-03-2024 03:00,72,73,71,73,68,70.83,Buy,2
18-03-2024 02:45,69,72,67,72,96,70.54310345,Buy,5
18-03-2024 02:30,72,73,69,70,136,70.86764706,Sell,4
15-03-2024 09:45,70,71,68,70,48,71.87240076,Sell,3
15-03-2024 09:30,69,70,69,70,5,72.00891089,Buy,1
15-03-2024 09:15,70,70,69,69,10,72.02089552,Sell,1
15-03-2024 09:00,69,71,69,70,11,72.04422111,Buy,2
15-03-2024 08:45,70,70,69,70,17,72.07113821,Sell,1
15-03-2024 08:30,71,71,70,71,3,72.11892451,Sell,1
15-03-2024 08:15,71,71,70,70,5,72.12344398,Sell,1
15-03-2024 08:00,70,71,70,71,9,72.13347237,Buy,1
15-03-2024 07:45,71,71,70,70,20,72.15052632,Sell,1
15-03-2024 07:30,71,71,71,71,17,72.18709677,Sell,0
15-03-2024 07:15,72,72,71,71,100,72.20920044,Sell,1
15-03-2024 07:00,71,72,71,71,69,72.30504305,Sell,1
15-03-2024 06:45,71,72,71,71,85,72.40725806,Sell,1
15-03-2024 06:30,73,74,72,72,180,72.47951442,Sell,2
15-03-2024 04:15,73,73,73,73,1,72.41962422,Sell,0
15-03-2024 04:00,74,74,74,74,1,72.41841004,Sell,0
15-03-2024 03:45,75,75,74,74,42,72.41509434,Sell,1
15-03-2024 03:30,74,74,74,74,1,72.25517241,Sell,0
15-03-2024 03:15,74,75,74,74,42,72.25115207,Sell,1
15-03-2024 03:00,74,75,74,75,33,71.99744898,Buy,1
15-03-2024 02:45,74,74,72,73,17,71.74651811,Sell,2
15-03-2024 02:30,71,75,70,74,103,71.6871345,Buy,5
14-03-2024 15:15,71,72,71,71,22,71.0209205,Sell,1
14-03-2024 15:00,71,71,70,70,13,70.98617512,Sell,1
14-03-2024 14:30,71,71,71,71,2,71.01960784,Sell,0
14-03-2024 14:15,72,73,71,71,8,71.01980198,Sell,2
14-03-2024 14:00,72,73,70,70,41,70.98453608,Sell,3
14-03-2024 13:45,70,72,70,71,149,70.71895425,Buy,2
14-03-2024 13:30,69,69,69,69,1,69.25,Sell,0
14-03-2024 13:15,69,69,69,69,2,69.33333333,Sell,0
14-03-2024 13:00,70,70,70,70,1,70,Sell,0
14-03-2024 09:45,70,70,69,69,13,68.02295633,Sell,1
14-03-2024 09:30,70,70,68,68,23,68.0107163,Sell,2
14-03-2024 09:15,69,70,69,69,8,67.99885714,Sell,1
14-03-2024 09:00,70,70,70,70,19,67.99368542,Sell,0
14-03-2024 08:45,70,70,69,69,34,67.97156123,Sell,1
14-03-2024 08:30,70,70,70,70,10,67.94671403,Sell,0
14-03-2024 08:15,70,71,69,69,26,67.93448481,Sell,2
14-03-2024 08:00,70,72,69,71,118,67.91046582,Buy,3
14-03-2024 07:45,70,70,70,70,9,67.72247557,Sell,0
14-03-2024 07:30,71,72,71,71,33,67.70904325,Sell,1
14-03-2024 07:15,74,74,71,71,24,67.61821835,Sell,3
14-03-2024 07:00,71,74,70,74,210,67.54390742,Buy,4
14-03-2024 06:45,70,71,69,71,134,66.84273233,Buy,2
14-03-2024 06:30,69,73,69,71,131,66.40266667,Buy,4
14-03-2024 04:15,69,70,68,69,82,65.79879276,Sell,2
14-03-2024 04:00,69,69,67,68,56,65.52960526,Sell,2
14-03-2024 03:45,67,69,67,69,86,65.36448598,Buy,2
14-03-2024 03:30,68,69,67,68,75,64.98441558,Sell,2
14-03-2024 03:15,69,69,66,67,147,64.69352518,Sell,3
14-03-2024 03:00,68,70,68,70,69,63.94890511,Buy,2
14-03-2024 02:45,67,71,67,69,127,63.29227557,Buy,4
14-03-2024 02:30,60,67,59,67,276,61.17329545,Buy,8
13-03-2024 15:15,57,57,57,57,1,56.88157895,Sell,0
13-03-2024 15:00,57,57,57,57,1,56.88,Sell,0
13-03-2024 14:30,56,56,56,56,8,56.87837838,Sell,0
13-03-2024 14:15,57,57,57,57,10,56.98484848,Sell,0
13-03-2024 13:30,57,57,57,57,24,56.98214286,Sell,0
13-03-2024 13:15,56,56,56,56,1,56.96875,Sell,0
13-03-2024 13:00,57,58,56,56,31,57,Sell,2
13-03-2024 09:45,56,57,56,57,43,54.24840764,Buy,1
13-03-2024 09:30,56,57,56,56,30,54.14126808,Sell,1
13-03-2024 09:15,57,57,56,56,23,54.05178366,Sell,1
13-03-2024 09:00,55,57,55,57,91,53.99527187,Buy,2
13-03-2024 08:45,54,55,54,55,8,53.69006623,Buy,1
13-03-2024 08:30,55,55,54,54,29,53.67871486,Sell,1
13-03-2024 08:15,55,56,55,56,30,53.64345404,Buy,1
13-03-2024 08:00,55,55,55,55,2,53.5755814,Sell,0
13-03-2024 07:45,56,56,56,56,4,53.57142857,Sell,0
13-03-2024 07:30,55,56,55,56,26,53.55718475,Buy,1
13-03-2024 07:15,54,54,54,54,5,53.49847561,Sell,0
13-03-2024 07:00,54,55,54,55,7,53.49462366,Buy,1
13-03-2024 06:45,55,55,53,54,67,53.47981366,Sell,2
13-03-2024 06:30,55,56,55,56,25,53.37435009,Buy,1
13-03-2024 04:15,55,55,55,55,1,53.29710145,Sell,0
13-03-2024 04:00,55,55,55,55,10,53.29401089,Sell,0
13-03-2024 03:45,55,55,55,55,6,53.26247689,Sell,0
13-03-2024 03:30,55,56,55,55,17,53.24299065,Sell,1
13-03-2024 03:15,55,55,55,55,22,53.15830116,Sell,0
13-03-2024 03:00,54,55,53,55,71,53.0766129,Buy,2
13-03-2024 02:45,54,54,53,54,51,52.88,Sell,1
13-03-2024 02:30,54,55,52,54,206,52.73796791,Sell,3
12-03-2024 15:15,53,54,53,54,41,51.76190476,Buy,1
12-03-2024 15:00,52,53,52,53,47,51.07874016,Buy,1
12-03-2024 14:45,51,52,51,52,30,50.2125,Buy,1
12-03-2024 14:15,50,50,50,50,18,49.68,Sell,0
12-03-2024 14:00,49,49,49,49,1,49.5,Sell,0
12-03-2024 13:45,49,50,49,49,11,49.51612903,Sell,1
12-03-2024 13:30,50,50,50,50,11,49.35,Sell,0
12-03-2024 13:15,49,49,49,49,5,48.55555556,Sell,0
12-03-2024 13:00,48,48,48,48,4,48,Sell,0
12-03-2024 09:45,50,50,49,49,19,49.63880289,Sell,1
12-03-2024 09:30,49,49,49,49,19,49.63894737,Sell,0
12-03-2024 09:15,50,50,49,49,22,49.65198711,Sell,1
12-03-2024 09:00,49,50,49,50,10,49.65676568,Buy,1
12-03-2024 08:45,48,49,48,49,15,49.65517241,Buy,1
12-03-2024 08:30,49,49,48,48,85,49.66742081,Sell,1
12-03-2024 08:15,50,50,50,50,6,49.82853567,Sell,0
12-03-2024 08:00,49,49,49,49,12,49.82723834,Sell,0
12-03-2024 07:45,51,51,49,50,25,49.83994878,Sell,2
12-03-2024 07:30,50,50,50,50,5,49.84259259,Sell,0
12-03-2024 07:15,50,51,50,51,12,49.84154461,Buy,1
12-03-2024 07:00,50,50,48,49,61,49.8376184,Sell,2
12-03-2024 06:45,50,50,49,50,60,49.91887906,Sell,1
12-03-2024 06:30,52,53,48,49,146,49.96116505,Sell,5
12-03-2024 04:15,53,53,52,52,28,49.77118644,Sell,1
12-03-2024 04:00,50,53,50,53,168,49.59009009,Buy,3
12-03-2024 03:45,50,50,49,49,75,48.57246377,Sell,1
12-03-2024 03:15,50,50,49,49,24,48.15422886,Sell,1
12-03-2024 03:00,48,49,47,49,65,47.92655367,Buy,2
12-03-2024 02:45,46,48,46,48,16,47.64285714,Buy,2
12-03-2024 02:30,47,47,46,46,35,47.75,Sell,1
11-03-2024 15:00,48,48,47,48,7,48.68852459,Sell,1
11-03-2024 14:45,48,48,48,48,1,48.81481481,Sell,0
11-03-2024 14:00,48,48,48,48,3,48.83018868,Sell,0
11-03-2024 13:15,48,49,47,49,17,48.88,Buy,2
11-03-2024 13:00,49,50,48,48,33,49.09090909,Sell,2
11-03-2024 09:45,45,49,43,49,212,44.33819951,Buy,6
11-03-2024 09:30,45,45,45,45,16,43.5,Sell,0
11-03-2024 09:15,44,45,44,44,6,43.45959596,Sell,1
11-03-2024 09:00,43,43,43,43,1,43.45238095,Sell,0
11-03-2024 08:15,45,45,44,44,19,43.45315162,Sell,1
11-03-2024 08:00,43,46,43,44,162,43.42077465,Buy,3
11-03-2024 07:45,43,44,42,44,4,42.88423645,Buy,2
11-03-2024 07:15,43,43,43,43,1,42.88308458,Sell,0
11-03-2024 07:00,42,43,42,43,36,42.88279302,Buy,1
11-03-2024 06:45,43,44,42,42,46,42.94520548,Sell,2
11-03-2024 06:30,43,43,41,43,91,42.96865204,Sell,2
11-03-2024 04:00,43,43,43,43,12,43.30263158,Sell,0
11-03-2024 03:15,44,44,42,42,58,43.31944444,Sell,2
11-03-2024 03:00,43,43,43,43,21,43.66455696,Sell,0
11-03-2024 02:45,44,44,43,43,76,43.76642336,Sell,1
11-03-2024 02:30,44,46,44,44,61,44.39344262,Sell,2
08-03-2024 09:45,47,47,45,45,87,46.86839482,Sell,2
08-03-2024 09:30,48,48,47,47,38,47.00327511,Sell,1
08-03-2024 09:00,48,48,48,48,1,46.98063781,Sell,0
08-03-2024 08:45,49,49,48,49,19,46.97947548,Sell,1
08-03-2024 08:30,48,49,48,48,33,46.93589744,Sell,1
08-03-2024 08:15,48,48,48,48,40,46.88242424,Sell,0
08-03-2024 08:00,47,47,46,47,27,46.82547771,Sell,1
08-03-2024 07:45,48,48,48,48,3,46.83113456,Sell,0
08-03-2024 07:30,48,49,48,48,14,46.82649007,Sell,1
08-03-2024 07:15,47,48,47,47,49,46.80161943,Sell,1
08-03-2024 07:00,45,47,45,47,62,46.76589595,Buy,2
08-03-2024 06:45,46,47,45,46,148,46.78412698,Sell,2
08-03-2024 06:30,46,47,45,46,79,47.093361,Sell,2
08-03-2024 04:15,45,46,45,45,54,47.28287841,Sell,1
08-03-2024 04:00,46,46,45,46,33,47.63323782,Sell,1
08-03-2024 03:45,47,47,46,47,36,47.81012658,Sell,1
08-03-2024 03:30,47,47,46,47,29,47.91785714,Sell,1
08-03-2024 03:15,47,48,46,46,22,48.05179283,Sell,2
08-03-2024 03:00,47,47,46,47,61,48.15283843,Sell,1
08-03-2024 02:45,50,50,47,47,67,48.77380952,Sell,3
08-03-2024 02:30,50,51,49,49,31,49.3960396,Sell,2
07-03-2024 15:00,49,49,49,49,10,48.92857143,Sell,0
07-03-2024 14:45,49,49,49,49,4,48.91666667,Sell,0
07-03-2024 14:15,50,50,50,50,1,48.91071429,Sell,0
07-03-2024 14:00,49,50,49,50,19,48.89090909,Buy,1
07-03-2024 13:45,49,49,48,48,8,48.52777778,Sell,1
07-03-2024 13:30,48,48,48,48,3,48.64285714,Sell,0
07-03-2024 13:15,49,49,49,49,8,48.72,Sell,0
07-03-2024 13:00,48,49,47,49,17,48.58823529,Buy,2
07-03-2024 09:45,47,49,47,49,72,47.97997775,Buy,2
07-03-2024 09:30,48,49,47,47,56,47.93228537,Sell,2
07-03-2024 09:15,48,49,48,49,43,47.95071336,Buy,1
07-03-2024 09:00,47,48,47,48,6,47.91895604,Buy,1
07-03-2024 08:45,47,47,47,47,6,47.92105263,Sell,0
07-03-2024 08:30,47,47,47,47,4,47.92877095,Sell,0
07-03-2024 08:15,48,48,46,47,95,47.93398876,Sell,2
07-03-2024 08:00,48,48,47,48,20,48.02755267,Sell,1
07-03-2024 07:45,48,48,48,48,4,48.04355109,Sell,0
07-03-2024 07:30,50,50,48,48,34,48.04384486,Sell,2
07-03-2024 07:15,49,49,49,49,2,47.95169946,Sell,0
07-03-2024 07:00,49,49,49,49,38,47.94793537,Sell,0
07-03-2024 06:45,48,49,47,49,26,47.87090559,Buy,2
07-03-2024 06:30,48,48,48,48,5,47.84989858,Sell,0
07-03-2024 04:15,47,47,46,46,3,47.84836066,Sell,1
07-03-2024 03:45,45,47,45,47,13,47.8556701,Buy,2
07-03-2024 03:30,44,45,43,44,95,47.92161017,Sell,2
07-03-2024 03:15,47,47,44,44,76,48.88328912,Sell,3
07-03-2024 03:00,47,47,47,47,16,49.70431894,Sell,0
07-03-2024 02:45,48,48,47,48,17,49.85614035,Sell,1
07-03-2024 02:30,50,50,47,48,88,49.98507463,Sell,3
06-03-2024 15:15,50,51,50,51,3,50.61111111,Buy,1
06-03-2024 15:00,50,50,49,49,7,50.61016949,Sell,1
06-03-2024 14:45,50,50,50,50,21,50.67058824,Sell,0
06-03-2024 14:30,50,50,49,49,6,50.76510067,Sell,1
06-03-2024 14:15,51,51,50,50,13,50.8041958,Sell,1
06-03-2024 14:00,51,51,50,50,54,50.81538462,Sell,1
06-03-2024 13:45,51,51,51,51,1,51.35526316,Sell,0
06-03-2024 13:30,51,52,51,51,30,51.36,Sell,1
06-03-2024 13:15,53,53,51,51,38,51.55555556,Sell,2
06-03-2024 13:00,53,53,53,53,7,53,Sell,0
