Timestamp,Open,High,Low,Close,Volume,VWAP,Type,Range
16-04-2024 09:45,105,108,100,101,125,113.7068966,Sell,8
16-04-2024 09:30,110,110,107,107,92,114.8693135,Sell,3
16-04-2024 09:15,109,111,108,110,60,115.3554163,Buy,3
16-04-2024 09:00,110,111,109,111,15,115.7095553,Buy,2
16-04-2024 08:45,112,112,110,110,41,115.7879079,Sell,2
16-04-2024 08:30,115,115,112,112,51,115.985015,Sell,3
16-04-2024 08:15,115,115,115,115,1,116.1063158,Sell,0
16-04-2024 07:45,116,116,115,116,8,116.1074816,Sell,1
16-04-2024 07:30,118,118,115,115,9,116.1105207,Sell,3
16-04-2024 07:15,121,121,117,119,49,116.1072961,Sell,4
16-04-2024 07:00,119,122,118,121,161,115.9003398,Buy,4
16-04-2024 06:45,115,119,113,119,75,114.8698061,Buy,6
16-04-2024 06:30,115,118,114,115,60,114.7171561,Sell,4
16-04-2024 04:15,117,117,115,115,16,114.5536627,Sell,2
16-04-2024 04:00,119,119,117,117,5,114.5218914,Sell,2
16-04-2024 03:45,119,120,119,120,14,114.4946996,Buy,1
16-04-2024 03:30,118,121,118,120,84,114.3713768,Buy,3
16-04-2024 03:15,116,117,116,116,13,113.4380342,Sell,1
16-04-2024 03:00,113,118,113,118,70,113.356044,Buy,5
16-04-2024 02:45,113,115,111,115,198,112.9376623,Buy,4
16-04-2024 02:30,111,115,108,113,103,111.9197861,Buy,7
15-04-2024 15:00,111,111,110,110,3,112.0595238,Sell,1
15-04-2024 14:45,111,111,111,111,2,112.1234568,Sell,0
15-04-2024 14:30,111,111,111,111,2,112.1518987,Sell,0
15-04-2024 14:00,112,112,109,110,16,112.1818182,Sell,3
15-04-2024 13:45,111,111,110,111,22,112.8688525,Sell,1
15-04-2024 13:30,112,112,112,112,1,114.2307692,Sell,0
15-04-2024 13:15,113,114,112,112,12,114.2894737,Sell,2
15-04-2024 13:00,117,117,114,114,26,115.0384615,Sell,3
15-04-2024 09:45,119,120,117,119,55,120.84,Sell,3
15-04-2024 09:30,117,119,117,119,37,121,Buy,2
15-04-2024 09:00,117,117,117,117,4,121.1662269,Sell,0
15-04-2024 08:45,117,123,115,116,122,121.1883289,Sell,8
15-04-2024 08:30,115,118,115,117,26,121.4873418,Buy,3
15-04-2024 08:15,115,116,115,116,6,121.6914191,Buy,1
15-04-2024 08:00,113,117,113,117,30,121.7566667,Buy,4
15-04-2024 07:45,117,117,114,114,17,122.0631579,Sell,3
15-04-2024 07:30,118,118,117,118,14,122.2857143,Sell,1
15-04-2024 07:15,120,121,120,120,13,122.4100186,Sell,1
15-04-2024 07:00,123,123,120,120,64,122.4676806,Sell,3
15-04-2024 06:45,123,125,123,124,37,122.5454545,Buy,2
15-04-2024 06:30,118,124,118,123,180,122.4517647,Buy,6
15-04-2024 04:15,119,121,118,118,109,123.0040816,Sell,3
15-04-2024 04:00,119,119,119,119,5,125.3235294,Sell,0
15-04-2024 03:45,121,121,120,120,3,125.5648855,Sell,1
15-04-2024 03:30,119,119,119,119,1,125.6796875,Sell,0
15-04-2024 03:15,121,121,119,119,12,125.7322835,Sell,2
15-04-2024 03:00,123,123,121,121,12,126.3826087,Sell,2
15-04-2024 02:45,127,127,123,123,44,126.8834951,Sell,4
15-04-2024 02:30,130,132,125,127,59,127.8305085,Sell,7
12-04-2024 09:45,133,134,128,128,45,125.6362069,Sell,6
12-04-2024 09:30,131,133,128,133,30,125.2074766,Buy,5
12-04-2024 09:15,130,132,130,132,23,124.8653465,Buy,2
12-04-2024 09:00,130,130,128,128,10,124.5684647,Sell,2
12-04-2024 08:45,129,131,129,131,10,124.4872881,Buy,2
12-04-2024 08:30,127,130,127,130,2,124.3549784,Buy,3
12-04-2024 08:15,128,129,128,129,8,124.3369565,Buy,1
12-04-2024 08:00,127,128,127,128,15,124.2566372,Buy,1
12-04-2024 07:45,125,125,123,123,3,124.1578947,Sell,2
12-04-2024 07:30,124,124,123,123,11,124.156682,Sell,1
12-04-2024 07:00,123,123,122,123,10,124.1654846,Sell,1
12-04-2024 06:45,124,124,122,122,35,124.2009685,Sell,2
12-04-2024 06:30,124,127,124,124,54,124.2883598,Sell,3
12-04-2024 04:00,125,125,125,125,1,124.0030864,Sell,0
12-04-2024 03:45,123,123,122,122,36,124,Sell,1
12-04-2024 03:30,122,124,122,124,8,124.2334495,Buy,2
12-04-2024 03:15,122,123,122,122,57,124.2616487,Sell,1
12-04-2024 03:00,125,125,119,121,41,124.8198198,Sell,6
12-04-2024 02:45,124,126,120,124,96,125.640884,Sell,6
12-04-2024 02:30,139,139,124,125,85,129.0941176,Sell,15
09-04-2024 09:45,138,138,135,135,29,136.3687231,Sell,3
09-04-2024 09:30,138,138,138,138,4,136.3458084,Sell,0
09-04-2024 09:15,139,139,137,137,12,136.3358434,Sell,2
09-04-2024 08:00,138,141,137,141,42,136.2990798,Buy,4
09-04-2024 07:45,139,139,138,138,3,136.0803279,Sell,1
09-04-2024 07:30,139,139,139,139,5,136.0691928,Sell,0
09-04-2024 07:15,138,140,138,140,16,136.0448505,Buy,2
09-04-2024 07:00,137,138,136,138,7,135.9658703,Buy,2
09-04-2024 06:45,140,140,137,138,54,135.9602763,Sell,3
09-04-2024 06:30,137,139,134,139,40,135.7466667,Buy,5
09-04-2024 04:15,134,136,134,136,9,135.7237113,Buy,2
09-04-2024 04:00,135,135,135,135,1,135.7310924,Sell,0
09-04-2024 03:45,133,134,133,134,48,135.7326316,Buy,1
09-04-2024 03:30,135,135,133,133,32,135.941452,Sell,2
09-04-2024 03:15,135,137,135,135,113,136.1139241,Sell,2
09-04-2024 03:00,137,139,136,136,33,135.9964539,Sell,3
09-04-2024 02:45,136,138,133,138,15,135.7188755,Buy,5
09-04-2024 02:30,136,138,132,135,158,135.7222222,Sell,6
08-04-2024 15:15,137,137,137,137,2,138.3289474,Sell,0
08-04-2024 15:00,140,141,140,141,4,138.3648649,Buy,1
08-04-2024 14:45,136,139,136,139,9,138.2428571,Buy,3
08-04-2024 14:30,137,137,136,136,9,138.3770492,Sell,1
08-04-2024 14:15,137,138,137,138,27,138.6923077,Buy,1
08-04-2024 14:00,139,141,138,140,8,139.72,Buy,3
08-04-2024 13:45,137,139,137,139,6,139.8235294,Buy,2
08-04-2024 13:15,140,140,140,140,1,140.4545455,Sell,0
08-04-2024 13:00,140,141,139,139,10,140.5,Sell,2
08-04-2024 09:45,137,140,137,140,52,135.9891501,Buy,3
08-04-2024 09:30,136,137,135,135,16,135.6826347,Sell,2
08-04-2024 09:15,134,134,134,134,4,135.6927835,Sell,0
08-04-2024 09:00,135,137,134,134,22,135.7068607,Sell,3
08-04-2024 08:45,137,137,135,135,9,135.7124183,Sell,2
08-04-2024 08:30,135,135,135,135,6,135.7022222,Sell,0
08-04-2024 08:15,138,138,135,135,22,135.7117117,Sell,3
08-04-2024 08:00,136,138,136,138,16,135.7109005,Buy,2
08-04-2024 07:45,136,136,135,135,13,135.6527094,Sell,1
08-04-2024 07:30,135,138,135,138,7,135.6692112,Buy,3
08-04-2024 07:15,135,135,135,135,12,135.6476684,Sell,0
08-04-2024 07:00,135,135,135,135,1,135.6684492,Sell,0
08-04-2024 06:45,136,139,135,135,39,135.6702413,Sell,4
08-04-2024 06:30,134,136,132,136,79,135.4371257,Buy,4
08-04-2024 04:15,140,141,133,133,85,135.7215686,Sell,8
08-04-2024 04:00,143,146,143,145,8,135.4764706,Buy,3
08-04-2024 03:45,137,143,137,142,17,135.037037,Buy,6
08-04-2024 03:30,137,137,137,137,2,134.4827586,Sell,0
08-04-2024 03:15,133,138,131,137,30,134.4475524,Buy,7
08-04-2024 03:00,135,136,132,135,45,134.1504425,Sell,4
08-04-2024 02:45,134,134,134,134,1,134.3529412,Sell,0
08-04-2024 02:30,140,141,129,133,67,134.358209,Sell,12
05-04-2024 09:45,138,138,137,138,38,130.497992,Sell,1
05-04-2024 09:30,136,138,136,138,42,129.9108696,Buy,2
05-04-2024 09:15,136,136,136,136,4,129.1291866,Sell,0
05-04-2024 08:45,135,136,133,133,5,129.0628019,Sell,3
05-04-2024 08:30,131,135,131,135,52,128.99511,Buy,4
05-04-2024 08:15,130,130,130,130,4,128.32493,Sell,0
05-04-2024 08:00,133,133,128,128,56,128.305949,Sell,5
05-04-2024 07:45,132,135,131,135,13,128.2121212,Buy,4
05-04-2024 07:30,133,133,131,133,3,128.0140845,Sell,2
05-04-2024 07:15,132,132,132,132,5,127.9679715,Sell,0
05-04-2024 07:00,132,132,132,132,11,127.8949275,Sell,0
05-04-2024 06:45,127,131,125,131,27,127.7245283,Buy,6
05-04-2024 06:30,127,128,125,125,29,127.7563025,Sell,3
05-04-2024 03:30,125,125,125,125,1,127.9712919,Sell,0
05-04-2024 03:00,124,124,124,124,1,127.9855769,Sell,0
05-04-2024 02:45,126,127,125,125,13,128.0048309,Sell,2
05-04-2024 02:30,126,126,125,125,20,128.1340206,Sell,1
04-04-2024 15:15,126,126,126,126,11,128.4425287,Sell,0
04-04-2024 15:00,127,127,126,126,63,128.607362,Sell,1
04-04-2024 14:45,128,128,127,127,7,129.63,Sell,1
04-04-2024 14:15,130,132,128,128,22,129.8064516,Sell,4
04-04-2024 14:00,130,130,130,130,8,130.0985915,Sell,0
04-04-2024 13:45,131,131,130,130,32,130.1111111,Sell,1
04-04-2024 13:30,131,131,131,131,1,130.1612903,Sell,0
04-04-2024 13:15,130,130,130,130,27,130.1333333,Sell,0
04-04-2024 13:00,132,132,131,131,3,131.3333333,Sell,1
04-04-2024 09:45,132,135,132,135,17,134.8247822,Buy,3
04-04-2024 09:30,132,133,130,132,26,134.8474409,Sell,3
04-04-2024 09:15,130,130,129,130,25,134.9262626,Sell,1
04-04-2024 09:00,131,133,131,131,8,135.0569948,Sell,2
04-04-2024 08:45,133,133,131,132,18,135.0867294,Sell,2
04-04-2024 08:30,133,133,132,132,11,135.1458999,Sell,1
04-04-2024 08:15,133,135,132,134,50,135.1767241,Buy,3
04-04-2024 08:00,131,131,131,131,11,135.2300683,Sell,0
04-04-2024 07:45,131,133,131,131,18,135.283737,Sell,2
04-04-2024 07:15,131,132,131,131,58,135.3533569,Sell,1
04-04-2024 07:00,133,133,133,133,5,135.6713021,Sell,0
04-04-2024 06:45,133,133,131,131,21,135.6882952,Sell,2
04-04-2024 06:30,134,134,132,134,11,135.7751634,Sell,2
04-04-2024 04:15,132,134,132,134,4,135.8103448,Buy,2
04-04-2024 04:00,135,135,133,133,9,135.828,Sell,2
04-04-2024 03:45,135,135,135,135,26,135.8461538,Sell,0
04-04-2024 03:30,138,138,135,135,35,135.8769231,Sell,3
04-04-2024 03:15,136,137,136,137,18,135.8926471,Buy,1
04-04-2024 03:00,138,139,135,136,120,135.8716012,Sell,4
04-04-2024 02:45,138,138,137,138,12,135.6808118,Sell,1
04-04-2024 02:30,133,138,133,137,10,135.6396226,Buy,5
03-04-2024 15:15,133,136,132,136,26,135.6403846,Buy,4
03-04-2024 15:00,134,134,133,133,172,135.7753036,Sell,1
03-04-2024 14:45,135,135,133,134,36,136.8975155,Sell,2
03-04-2024 14:30,135,136,134,136,33,137.2412587,Buy,2
03-04-2024 14:15,138,138,135,135,113,137.5454545,Sell,3
03-04-2024 14:00,138,140,137,138,46,138.4571429,Sell,3
03-04-2024 13:45,139,139,138,138,39,138.7553191,Sell,1
03-04-2024 13:30,139,139,139,139,9,138.6,Sell,0
03-04-2024 13:15,136,139,136,139,32,138.5217391,Buy,3
03-04-2024 13:00,139,140,137,137,14,137.8571429,Sell,3
03-04-2024 09:45,143,146,139,139,491,147.3054911,Sell,7
03-04-2024 09:30,146,146,142,142,15,148.4210024,Sell,4
03-04-2024 09:15,150,150,148,148,28,148.4625,Sell,2
03-04-2024 09:00,150,152,150,150,61,148.4498051,Sell,2
03-04-2024 08:45,144,150,144,150,75,148.3932697,Buy,6
03-04-2024 08:30,143,144,143,144,4,148.4133612,Buy,1
03-04-2024 08:15,143,143,142,142,2,148.4231172,Sell,1
03-04-2024 08:00,138,143,138,143,50,148.4293194,Buy,5
03-04-2024 07:45,141,143,140,140,84,148.6241935,Sell,3
03-04-2024 07:30,141,142,140,140,204,149.0123874,Sell,2
03-04-2024 07:15,144,146,140,141,343,150.1100509,Sell,6
03-04-2024 07:00,147,148,143,146,82,152.2945484,Sell,5
03-04-2024 06:45,149,153,147,147,213,152.7846556,Sell,6
03-04-2024 06:30,152,154,149,149,189,153.6059957,Sell,5
03-04-2024 04:15,149,153,148,152,189,154.1691275,Buy,5
03-04-2024 04:00,151,151,150,150,22,155.2194245,Sell,1
03-04-2024 03:45,153,153,151,151,26,155.423221,Sell,2
03-04-2024 03:30,158,158,154,155,11,155.6181102,Sell,4
03-04-2024 03:15,155,158,154,157,34,155.6358149,Buy,4
03-04-2024 03:00,154,160,154,155,91,155.6328294,Buy,6
03-04-2024 02:45,154,154,152,152,21,155.2043011,Sell,2
03-04-2024 02:30,158,160,152,154,107,155.3532764,Sell,8
02-04-2024 15:15,157,158,157,158,12,154.5983607,Buy,1
02-04-2024 15:00,157,157,157,157,1,154.4267241,Sell,0
02-04-2024 14:45,157,157,157,157,8,154.4155844,Sell,0
02-04-2024 14:30,156,157,154,154,8,154.32287,Sell,3
02-04-2024 14:15,155,157,155,155,30,154.2790698,Sell,2
02-04-2024 14:00,155,155,152,152,8,154,Sell,3
02-04-2024 13:45,157,157,154,156,16,154.0112994,Sell,3
02-04-2024 13:30,154,157,153,157,91,153.826087,Buy,4
02-04-2024 13:15,150,155,150,154,60,153.2857143,Buy,5
02-04-2024 13:00,150,150,148,150,10,149.2,Sell,2
02-04-2024 09:45,143,150,143,148,36,144.3275488,Buy,7
02-04-2024 09:30,143,144,141,144,50,144.0188235,Buy,3
02-04-2024 09:15,144,145,143,143,20,144.272,Sell,2
02-04-2024 08:45,144,145,144,144,33,144.2788732,Sell,1
02-04-2024 08:30,144,144,142,142,5,144.2515528,Sell,2
02-04-2024 08:15,144,144,144,144,5,144.2649842,Sell,0
02-04-2024 08:00,144,144,143,143,4,144.2692308,Sell,1
02-04-2024 07:45,142,144,142,144,7,144.275974,Buy,2
02-04-2024 07:30,145,145,144,144,64,144.2923588,Sell,1
02-04-2024 07:15,145,145,145,145,4,144.3628692,Sell,0
02-04-2024 07:00,147,147,147,147,1,144.3519313,Sell,0
02-04-2024 06:45,143,146,143,146,12,144.3405172,Buy,3
02-04-2024 06:30,142,143,141,143,109,144.3181818,Buy,2
02-04-2024 04:15,142,142,141,142,7,146.6126126,Sell,1
02-04-2024 03:45,146,146,145,145,15,146.9711538,Sell,1
02-04-2024 03:30,147,147,147,147,1,147.1685393,Sell,0
02-04-2024 03:15,151,151,149,149,3,147.1704545,Sell,2
02-04-2024 02:45,145,148,145,148,5,147.0588235,Buy,3
02-04-2024 02:30,148,148,148,148,4,147.1125,Sell,0
01-04-2024 15:15,147,147,147,147,38,147.0657895,Sell,0
01-04-2024 15:00,148,148,148,148,2,147.1315789,Sell,0
01-04-2024 14:30,147,147,147,147,1,147.0833333,Sell,0
01-04-2024 13:45,147,147,147,147,2,147.0857143,Sell,0
01-04-2024 13:30,147,147,147,147,2,147.0909091,Sell,0
01-04-2024 13:15,147,147,147,147,13,147.0967742,Sell,0
01-04-2024 13:00,148,148,146,146,18,147.1666667,Sell,2
01-04-2024 09:45,150,150,150,150,1,149.8123077,Sell,0
01-04-2024 09:30,144,150,144,150,39,149.8117284,Buy,6
01-04-2024 09:15,144,144,143,143,6,150.1578947,Sell,1
01-04-2024 08:15,141,143,140,143,16,150.297491,Buy,3
01-04-2024 07:45,146,147,145,146,10,150.8593156,Sell,2
01-04-2024 07:30,149,149,147,147,13,151.0434783,Sell,2
01-04-2024 07:15,150,151,150,151,4,151.2125,Buy,1
01-04-2024 06:45,150,151,150,151,5,151.2288136,Buy,1
01-04-2024 06:30,156,158,145,146,44,151.2510823,Sell,13
01-04-2024 04:15,155,156,153,155,33,151.6791444,Sell,3
01-04-2024 04:00,155,155,155,155,3,151.0454545,Sell,0
01-04-2024 03:30,153,155,153,154,11,150.9668874,Buy,2
01-04-2024 03:15,153,153,152,153,5,150.6857143,Sell,1
01-04-2024 03:00,155,156,154,156,12,150.6148148,Buy,2
01-04-2024 02:45,153,157,153,156,39,150.1300813,Buy,4
01-04-2024 02:30,140,153,140,149,84,147.6904762,Buy,13
29-03-2024 09:45,137,138,134,138,24,136.7377691,Buy,4
29-03-2024 09:30,135,136,135,136,18,136.7453799,Buy,1
29-03-2024 09:15,137,137,134,135,27,136.7846482,Sell,3
29-03-2024 07:45,134,134,134,134,1,136.8506787,Sell,0
29-03-2024 07:30,135,135,135,135,3,136.8571429,Sell,0
29-03-2024 07:15,136,136,134,134,2,136.869863,Sell,2
29-03-2024 07:00,136,138,134,134,22,136.8784404,Sell,4
29-03-2024 06:45,135,135,135,135,7,136.9347826,Sell,0
29-03-2024 06:30,135,137,135,137,7,136.968059,Buy,2
29-03-2024 04:15,131,134,131,134,9,136.975,Buy,3
29-03-2024 04:00,131,132,131,132,2,137.0869565,Buy,1
29-03-2024 03:30,126,130,126,130,12,137.1156812,Buy,4
29-03-2024 03:15,135,135,125,126,169,137.3713528,Sell,10
29-03-2024 03:00,140,140,137,137,10,142.75,Sell,3
29-03-2024 02:45,140,141,140,140,65,143.010101,Sell,1
29-03-2024 02:30,146,149,140,140,133,144.4511278,Sell,9
27-03-2024 09:45,151,151,146,147,221,150.6645907,Sell,5
27-03-2024 09:30,149,150,149,149,42,151.2325581,Sell,1
27-03-2024 09:15,153,154,149,149,69,151.3252033,Sell,5
27-03-2024 08:45,154,154,154,154,2,151.4191919,Sell,0
27-03-2024 08:30,154,154,152,153,10,151.4126582,Sell,2
27-03-2024 08:00,153,153,152,152,5,151.3871795,Sell,1
27-03-2024 07:30,151,153,151,153,7,151.3780645,Buy,2
27-03-2024 07:15,151,152,151,152,4,151.3671875,Buy,1
27-03-2024 07:00,151,151,151,151,1,151.3651832,Sell,0
27-03-2024 06:30,152,152,151,151,3,151.3656619,Sell,1
27-03-2024 04:15,155,155,153,153,5,151.3644737,Sell,2
27-03-2024 04:00,154,156,154,154,9,151.3496689,Sell,2
27-03-2024 03:45,152,152,152,152,5,151.3069705,Sell,0
27-03-2024 03:30,152,152,152,152,3,151.3022942,Sell,0
27-03-2024 03:15,148,152,147,152,59,151.299458,Buy,5
27-03-2024 03:00,151,151,148,148,209,151.55081,Sell,3
27-03-2024 02:45,152,155,150,151,190,152.5297872,Sell,5
27-03-2024 02:30,152,152,151,152,81,153.2821429,Sell,1
26-03-2024 15:15,153,153,153,153,9,153.8140704,Sell,0
26-03-2024 15:00,154,154,153,153,2,153.8526316,Sell,1
26-03-2024 14:45,154,154,153,153,19,153.856383,Sell,1
26-03-2024 14:30,154,154,153,154,48,153.9289941,Sell,1
26-03-2024 14:15,154,155,154,155,3,153.9917355,Buy,1
26-03-2024 14:00,154,154,154,154,14,153.9830508,Sell,0
26-03-2024 13:45,154,154,153,154,48,153.9807692,Sell,1
26-03-2024 13:30,154,155,153,154,54,154.0178571,Sell,2
26-03-2024 13:15,155,155,155,155,2,155,Sell,0
26-03-2024 09:30,156,156,156,156,19,156.6123779,Sell,0
26-03-2024 09:15,156,156,156,156,2,156.6527778,Sell,0
26-03-2024 09:00,156,156,156,156,1,156.6573427,Sell,0
26-03-2024 08:45,156,156,156,156,8,156.6596491,Sell,0
26-03-2024 08:15,157,157,157,157,3,156.6787004,Sell,0
26-03-2024 07:30,156,156,156,156,3,156.6751825,Sell,0
26-03-2024 06:45,158,158,157,158,45,156.6826568,Sell,1
26-03-2024 06:30,156,156,156,156,38,156.4247788,Sell,0
26-03-2024 04:15,158,160,158,160,4,156.5106383,Buy,2
26-03-2024 04:00,159,160,159,160,20,156.4673913,Buy,1
26-03-2024 03:45,155,155,155,155,4,156.1402439,Sell,0
26-03-2024 03:30,155,158,155,157,23,156.16875,Buy,3
26-03-2024 03:15,155,156,155,156,6,156.0948905,Buy,1
26-03-2024 03:00,155,155,155,155,24,156.1068702,Sell,0
26-03-2024 02:45,157,157,153,156,25,156.3551402,Sell,4
26-03-2024 02:30,159,159,158,158,3,156.7560976,Sell,1
25-03-2024 15:15,156,160,156,160,10,156.6962025,Buy,4
25-03-2024 14:00,160,160,160,160,4,156.5072464,Sell,0
25-03-2024 13:30,159,159,159,159,2,156.2923077,Sell,0
25-03-2024 13:15,155,160,155,160,48,156.2063492,Buy,5
25-03-2024 13:00,156,156,153,155,15,154.8666667,Sell,3
25-03-2024 09:45,160,160,157,158,190,156.7166948,Sell,3
25-03-2024 09:30,159,160,159,160,99,155.9081886,Buy,1
25-03-2024 09:15,159,161,159,159,8,154.6151316,Sell,2
25-03-2024 09:00,159,159,159,159,37,154.4864865,Sell,0
25-03-2024 08:45,161,163,159,160,69,153.8416988,Sell,4
25-03-2024 08:30,161,163,161,163,7,151.2368421,Buy,2
25-03-2024 08:15,155,161,155,161,52,150.8196721,Buy,6
25-03-2024 08:00,153,153,153,153,4,148.0916031,Sell,0
25-03-2024 07:30,152,152,151,151,4,147.9370079,Sell,1
25-03-2024 07:00,147,152,146,151,36,147.8130081,Buy,6
25-03-2024 06:45,150,150,150,150,15,146.954023,Sell,0
25-03-2024 06:30,149,150,147,149,19,146.3194444,Sell,3
25-03-2024 04:15,150,150,150,150,2,145.3396226,Sell,0
25-03-2024 04:00,149,150,149,150,9,145.1568627,Buy,1
25-03-2024 03:30,147,147,147,147,1,144.1666667,Sell,0
25-03-2024 03:15,148,148,145,148,6,144.097561,Sell,3
25-03-2024 03:00,144,144,142,144,12,143.6,Sell,2
25-03-2024 02:45,144,148,144,145,11,143.826087,Buy,4
25-03-2024 02:30,145,145,140,142,12,142.4166667,Sell,5
22-03-2024 09:45,148,148,145,148,3,148.4543478,Sell,3
22-03-2024 09:00,144,145,144,145,2,148.4591058,Buy,1
22-03-2024 08:45,146,146,144,144,128,148.4677596,Sell,2
22-03-2024 08:00,145,146,145,146,3,149.1639136,Buy,1
22-03-2024 07:15,148,148,146,146,9,149.1772959,Sell,2
22-03-2024 07:00,147,149,147,149,3,149.2064516,Buy,2
22-03-2024 06:45,144,147,140,145,263,149.2098446,Buy,7
22-03-2024 06:30,151,151,143,143,119,152.2711198,Sell,8
22-03-2024 03:45,150,151,150,151,2,154.2179487,Buy,1
22-03-2024 03:30,150,150,150,150,1,154.2371134,Sell,0
22-03-2024 03:15,156,156,156,156,1,154.248062,Sell,0
22-03-2024 03:00,153,155,153,155,5,154.2435233,Buy,2
22-03-2024 02:45,149,149,148,149,13,154.2414698,Sell,1
22-03-2024 02:30,154,155,146,146,221,154.4375,Sell,9
21-03-2024 15:15,156,156,154,156,77,157.1632653,Sell,2
21-03-2024 15:00,156,156,156,156,19,158.4714286,Sell,0
21-03-2024 14:45,155,155,155,155,2,159.3921569,Sell,0
21-03-2024 14:30,155,155,155,155,3,159.5714286,Sell,0
21-03-2024 14:00,160,161,160,160,15,159.8695652,Sell,1
21-03-2024 13:45,160,160,160,160,2,159.6774194,Sell,0
21-03-2024 13:30,160,160,160,160,5,159.6551724,Sell,0
21-03-2024 13:15,159,161,157,160,24,159.5833333,Buy,4
21-03-2024 09:45,160,163,158,162,437,159.3234516,Buy,5
21-03-2024 09:30,158,159,158,159,5,159.0633609,Buy,1
21-03-2024 09:00,157,157,157,157,1,159.064962,Sell,0
21-03-2024 08:45,157,157,157,157,4,159.06639,Sell,0
21-03-2024 08:30,155,156,155,156,4,159.0721221,Buy,1
21-03-2024 08:15,154,154,154,154,1,159.0827538,Sell,0
21-03-2024 07:45,153,154,153,154,14,159.0862909,Buy,1
21-03-2024 07:30,154,154,153,153,5,159.1398454,Sell,1
21-03-2024 07:15,154,154,154,154,3,159.1607898,Sell,0
21-03-2024 07:00,153,153,153,153,2,159.1717314,Sell,0
21-03-2024 06:45,155,156,154,154,40,159.1804671,Sell,2
21-03-2024 06:30,163,163,154,155,357,159.3008012,Sell,9
21-03-2024 04:15,162,162,162,162,3,159.7057087,Sell,0
21-03-2024 04:00,162,162,162,162,3,159.6989141,Sell,0
21-03-2024 03:45,161,162,161,162,18,159.6920792,Buy,1
21-03-2024 03:30,161,161,161,161,1,159.6512097,Sell,0
21-03-2024 03:15,160,161,159,161,6,159.6498486,Buy,2
21-03-2024 03:00,158,158,158,158,5,159.648731,Sell,0
21-03-2024 02:45,157,162,157,158,32,159.6571429,Buy,5
21-03-2024 02:30,162,162,157,157,282,159.6466245,Sell,5
20-03-2024 15:15,163,163,160,160,24,159.9324324,Sell,3
20-03-2024 15:00,163,163,163,163,1,159.8613707,Sell,0
20-03-2024 14:45,163,167,162,165,33,159.8564743,Buy,5
20-03-2024 14:30,164,164,162,163,4,159.5707237,Sell,2
20-03-2024 14:15,161,162,161,162,43,159.5480132,Buy,1
20-03-2024 14:00,160,160,160,160,37,159.4313725,Sell,0
20-03-2024 13:45,161,161,160,160,14,159.3912214,Sell,1
20-03-2024 13:30,161,161,160,160,160,159.3509804,Sell,1
20-03-2024 13:15,158,161,157,161,48,158.6171429,Buy,4
20-03-2024 13:00,165,166,157,157,302,158.5927152,Sell,9
20-03-2024 09:45,157,163,157,161,65,151.5883838,Buy,6
20-03-2024 09:30,158,160,157,158,161,151.0863758,Sell,3
20-03-2024 09:15,156,157,155,156,23,149.9365904,Sell,2
20-03-2024 09:00,155,155,154,154,12,149.7859425,Sell,1
20-03-2024 08:45,151,155,151,155,23,149.7195254,Buy,4
20-03-2024 08:15,153,153,152,153,23,149.6404867,Sell,1
20-03-2024 08:00,153,153,153,153,25,149.5550511,Sell,0
20-03-2024 07:45,152,157,149,156,74,149.4544393,Buy,8
20-03-2024 07:30,152,153,152,152,116,149.3005115,Sell,1
20-03-2024 07:15,156,156,153,153,56,148.8243243,Sell,3
20-03-2024 07:00,157,157,157,157,13,148.2639344,Sell,0
20-03-2024 06:45,159,160,157,157,10,148.0737018,Sell,3
20-03-2024 06:30,153,157,151,157,67,147.8858603,Buy,6
20-03-2024 04:15,150,152,150,152,8,147.225,Buy,2
20-03-2024 04:00,152,152,148,151,34,147.1542969,Sell,4
20-03-2024 03:45,152,152,152,152,1,147.0292887,Sell,0
20-03-2024 03:30,151,151,151,151,11,147.0188679,Sell,0
20-03-2024 03:15,148,151,147,151,150,146.9248927,Buy,4
20-03-2024 03:00,145,149,145,149,120,145.7310127,Buy,4
20-03-2024 02:45,145,145,143,144,15,145.1428571,Sell,2
20-03-2024 02:30,145,147,143,143,40,145.2099448,Sell,4
19-03-2024 15:15,149,149,149,149,3,145.2907801,Sell,0
19-03-2024 15:00,149,149,149,149,4,145.2101449,Sell,0
19-03-2024 14:45,145,149,145,149,73,145.0970149,Buy,4
19-03-2024 14:30,144,145,144,145,8,143.3442623,Buy,1
19-03-2024 14:15,142,143,142,143,35,143.1509434,Buy,1
19-03-2024 14:00,142,142,142,142,2,143.6111111,Sell,0
19-03-2024 13:45,144,145,144,145,2,143.8125,Buy,1
19-03-2024 13:30,143,145,143,144,13,143.7142857,Buy,2
19-03-2024 13:15,143,143,143,143,1,143,Sell,0
19-03-2024 09:45,142,142,140,140,82,146.5706215,Sell,2
19-03-2024 09:30,142,142,142,142,2,147.7082405,Sell,0
19-03-2024 09:15,143,143,143,143,5,147.7337808,Sell,0
19-03-2024 08:45,140,142,139,141,107,147.7873303,Buy,3
19-03-2024 08:30,142,143,142,143,16,150.4865672,Buy,1
19-03-2024 08:15,140,141,139,141,6,150.8808777,Buy,2
19-03-2024 08:00,143,143,143,143,1,151.0926518,Sell,0
19-03-2024 07:30,140,143,140,143,6,151.1185897,Buy,3
19-03-2024 07:15,140,140,138,139,9,151.3071895,Sell,2
19-03-2024 06:30,141,141,141,141,1,151.6666667,Sell,0
19-03-2024 04:15,143,143,141,141,3,151.7027027,Sell,2
19-03-2024 04:00,144,144,144,144,2,151.8054608,Sell,0
19-03-2024 03:30,143,145,143,145,3,151.8591065,Buy,2
19-03-2024 03:00,139,139,139,139,3,151.9409722,Sell,0
19-03-2024 02:45,145,145,139,140,35,152.077193,Sell,6
19-03-2024 02:30,150,153,143,144,39,153.748,Sell,10
18-03-2024 15:15,148,149,148,148,8,154.8436019,Sell,1
18-03-2024 15:00,151,151,148,148,16,155.1034483,Sell,3
18-03-2024 14:45,150,150,148,148,14,155.6898396,Sell,2
18-03-2024 14:30,152,152,152,152,4,156.2427746,Sell,0
18-03-2024 14:15,152,152,152,152,17,156.3431953,Sell,0
18-03-2024 14:00,152,153,152,152,8,156.8289474,Sell,1
18-03-2024 13:45,156,156,151,152,28,157.0902778,Sell,5
18-03-2024 13:30,158,160,155,155,54,158.112069,Sell,5
18-03-2024 13:15,157,158,157,158,61,157.8548387,Buy,1
18-03-2024 13:00,155,155,155,155,1,155,Sell,0
18-03-2024 09:45,156,156,155,155,8,161.1727617,Sell,1
18-03-2024 09:30,160,161,160,161,49,161.2280255,Buy,1
18-03-2024 09:15,160,161,160,160,12,161.2717391,Sell,1
18-03-2024 08:45,164,164,161,161,43,161.2900552,Sell,3
18-03-2024 08:30,164,164,161,164,7,161.2951542,Sell,3
18-03-2024 08:15,166,166,163,163,15,161.2774481,Sell,3
18-03-2024 08:00,163,167,163,166,37,161.185129,Buy,4
18-03-2024 07:45,160,166,160,165,167,160.9212219,Buy,6
18-03-2024 07:30,160,161,160,160,58,160.3494505,Sell,1
18-03-2024 07:15,158,160,158,160,7,160.395466,Buy,2
18-03-2024 07:00,159,160,159,160,47,160.4128205,Buy,1
18-03-2024 06:45,159,159,154,154,13,160.4781341,Sell,5
18-03-2024 06:30,162,162,158,158,101,160.6727273,Sell,4
18-03-2024 04:15,164,165,164,165,2,161.0524017,Buy,1
18-03-2024 03:45,167,167,163,164,13,161.0220264,Sell,4
18-03-2024 03:30,160,166,159,166,81,160.771028,Buy,7
18-03-2024 03:15,157,160,156,160,59,160.3984962,Buy,4
18-03-2024 03:00,162,162,160,162,9,161.6216216,Sell,2
18-03-2024 02:45,159,162,158,161,42,161.6153846,Buy,4
18-03-2024 02:30,168,168,163,163,23,164.3913043,Sell,5
15-03-2024 09:45,162,164,162,163,36,165.8989726,Buy,2
15-03-2024 09:15,163,163,163,163,17,166.0456204,Sell,0
15-03-2024 09:00,163,163,163,163,1,166.1431262,Sell,0
15-03-2024 08:45,162,163,162,162,3,166.1490566,Sell,1
15-03-2024 08:30,165,165,165,165,2,166.170778,Sell,0
15-03-2024 08:15,165,165,165,165,11,166.1752381,Sell,0
15-03-2024 08:00,165,165,165,165,7,166.2003891,Sell,0
15-03-2024 07:45,166,166,165,165,19,166.2169625,Sell,1
15-03-2024 07:30,165,166,165,166,29,166.2377049,Buy,1
15-03-2024 07:15,165,165,164,164,90,166.3071895,Sell,1
15-03-2024 07:00,164,165,164,164,15,166.6775068,Sell,1
15-03-2024 06:45,165,165,164,165,47,166.7683616,Sell,1
15-03-2024 06:30,167,168,165,165,59,167.1530945,Sell,3
15-03-2024 04:15,168,168,167,167,9,167.2822581,Sell,1
15-03-2024 04:00,167,168,167,168,9,167.2635983,Buy,1
15-03-2024 03:45,170,170,168,168,79,167.2478261,Sell,2
15-03-2024 03:30,169,169,169,169,1,166.7748344,Sell,0
15-03-2024 03:00,170,171,170,171,5,166.76,Buy,1
15-03-2024 02:45,169,169,167,169,5,166.6344828,Sell,2
15-03-2024 02:30,165,170,165,170,31,166.5642857,Buy,5
14-03-2024 15:15,164,167,164,166,40,166.1651376,Buy,3
14-03-2024 14:00,169,170,166,166,7,166.4347826,Sell,4
14-03-2024 13:45,165,167,165,167,60,166.1774194,Buy,2
14-03-2024 13:30,162,163,162,163,2,162.5,Buy,1
14-03-2024 09:30,160,160,160,160,7,156.9059561,Sell,0
14-03-2024 08:45,161,161,158,161,20,156.8716323,Sell,3
14-03-2024 08:15,163,164,160,160,3,156.787234,Sell,4
14-03-2024 08:00,161,166,161,166,36,156.7598684,Buy,5
14-03-2024 07:45,165,165,165,165,4,156.256993,Sell,0
14-03-2024 07:30,165,165,165,165,2,156.1954225,Sell,0
14-03-2024 07:15,167,167,167,167,5,156.164311,Sell,0
14-03-2024 07:00,165,169,164,169,65,156.0677362,Buy,5
14-03-2024 06:45,166,166,163,163,8,154.7076613,Sell,3
14-03-2024 06:30,157,166,156,163,23,154.5491803,Buy,10
14-03-2024 04:15,155,157,153,153,105,154.1010753,Sell,4
14-03-2024 04:00,156,156,153,156,7,154.3722222,Sell,3
14-03-2024 03:45,157,158,156,156,22,154.3569405,Sell,2
14-03-2024 03:30,154,156,154,156,33,154.1933535,Buy,2
14-03-2024 03:15,159,159,153,153,144,154.1677852,Sell,6
14-03-2024 03:00,158,159,155,157,12,152.5779221,Sell,4
14-03-2024 02:45,158,164,157,163,17,152.1971831,Buy,7
14-03-2024 02:30,142,161,142,161,110,151.152,Buy,19
13-03-2024 15:15,139,139,139,139,2,138.4666667,Sell,0
13-03-2024 14:15,137,137,137,137,1,138.3846154,Sell,0
13-03-2024 13:15,135,135,135,135,1,138.5,Sell,0
13-03-2024 13:00,138,140,138,139,11,138.8181818,Buy,2
13-03-2024 09:45,135,136,135,136,11,132.7991747,Buy,1
13-03-2024 09:30,134,135,134,135,67,132.7625698,Buy,1
13-03-2024 09:15,135,136,135,135,46,132.5731895,Sell,1
13-03-2024 09:00,133,135,133,135,27,132.3731343,Buy,2
13-03-2024 08:45,132,132,129,129,3,132.3055556,Sell,3
13-03-2024 08:30,132,132,129,129,14,132.3123909,Sell,3
13-03-2024 08:15,134,134,132,132,36,132.3363148,Sell,2
13-03-2024 08:00,135,135,132,133,15,132.2332696,Sell,3
13-03-2024 07:45,134,134,134,134,2,132.1948819,Sell,0
13-03-2024 07:30,132,135,132,135,19,132.187747,Buy,3
13-03-2024 07:00,133,134,133,133,5,132.0924025,Sell,1
13-03-2024 06:45,135,135,131,132,78,132.0767635,Sell,4
13-03-2024 06:30,135,135,134,135,133,131.6806931,Sell,1
13-03-2024 04:15,134,135,134,135,10,130.2583026,Buy,1
13-03-2024 04:00,134,134,134,134,4,130.0957854,Sell,0
13-03-2024 03:45,135,135,135,135,6,130.0350195,Sell,0
13-03-2024 03:30,134,135,134,134,7,129.9163347,Sell,1
13-03-2024 03:15,132,134,132,134,30,129.795082,Buy,2
13-03-2024 03:00,130,130,129,130,22,129.2336449,Sell,1
13-03-2024 02:45,131,132,131,132,5,129.1770833,Buy,1
13-03-2024 02:30,133,134,129,131,77,129.1176471,Sell,5
12-03-2024 15:15,131,132,131,132,27,126.7181818,Buy,1
12-03-2024 15:00,130,132,130,132,3,125.3012048,Buy,2
12-03-2024 14:45,126,130,126,130,14,125.1,Buy,4
12-03-2024 14:15,125,125,125,125,15,124.3939394,Sell,0
12-03-2024 14:00,124,125,124,125,8,124.2156863,Buy,1
12-03-2024 13:45,124,124,124,124,12,124.0930233,Sell,0
12-03-2024 13:30,124,125,124,125,15,124.1290323,Buy,1
12-03-2024 13:15,124,124,124,124,15,124,Sell,0
12-03-2024 13:00,124,124,124,124,1,124,Sell,0
12-03-2024 09:45,126,126,123,124,17,124.8145161,Sell,3
12-03-2024 09:30,126,126,125,125,6,124.8159204,Sell,1
12-03-2024 09:15,126,126,126,126,9,124.8056951,Sell,0
12-03-2024 09:00,124,126,124,126,39,124.787415,Buy,2
12-03-2024 08:45,125,125,125,125,13,124.7595628,Sell,0
12-03-2024 08:30,127,127,123,124,36,124.7537313,Sell,4
12-03-2024 08:00,124,124,124,124,17,124.73,Sell,0
12-03-2024 07:45,129,129,125,125,24,124.7556936,Sell,4
12-03-2024 07:30,128,128,128,128,2,124.6688453,Sell,0
12-03-2024 07:15,126,128,126,128,8,124.654267,Buy,2
12-03-2024 07:00,126,126,124,125,130,124.6169265,Sell,2
12-03-2024 06:45,125,126,123,126,63,124.460815,Buy,3
12-03-2024 06:30,134,135,123,125,67,124.4101563,Sell,12
12-03-2024 04:15,135,135,133,133,9,122.6560847,Sell,2
12-03-2024 04:00,127,135,127,134,15,122.0833333,Buy,8
12-03-2024 03:45,126,126,125,125,11,121.2363636,Sell,1
12-03-2024 03:15,125,125,125,125,20,120.961039,Sell,0
12-03-2024 03:00,125,125,122,124,10,120.358209,Sell,3
12-03-2024 02:45,119,123,119,122,11,120.0483871,Buy,4
12-03-2024 02:30,117,117,117,117,3,119.9469027,Sell,0
11-03-2024 15:15,120,120,120,120,4,120.0272727,Sell,0
11-03-2024 15:00,120,120,119,119,19,120.0283019,Sell,1
11-03-2024 14:45,120,120,120,120,5,120.0574713,Sell,0
11-03-2024 14:30,119,119,119,119,1,120.0609756,Sell,0
11-03-2024 14:15,119,119,119,119,3,120.0740741,Sell,0
11-03-2024 14:00,121,121,119,119,10,120.1153846,Sell,2
11-03-2024 13:45,120,121,120,121,3,120.1323529,Buy,1
11-03-2024 13:30,121,121,121,121,4,120.1230769,Sell,0
11-03-2024 13:15,120,122,119,122,57,120.0655738,Buy,3
11-03-2024 13:00,122,122,120,120,4,121.5,Sell,2
11-03-2024 09:45,115,124,113,123,140,111.9548458,Buy,11
11-03-2024 09:30,114,116,114,116,18,111.2317708,Buy,2
11-03-2024 09:15,112,114,112,114,9,111.1466667,Buy,2
11-03-2024 09:00,111,112,111,112,13,111.122807,Buy,1
11-03-2024 08:45,111,111,111,111,7,111.1098901,Sell,0
11-03-2024 08:30,111,111,111,111,3,111.110957,Sell,0
11-03-2024 08:15,111,111,111,111,2,111.1114206,Sell,0
11-03-2024 08:00,112,116,111,112,70,111.1117318,Sell,5
11-03-2024 07:45,109,112,109,112,32,110.8204334,Buy,3
11-03-2024 07:30,109,109,109,109,1,110.781759,Sell,0
11-03-2024 07:15,109,111,109,111,2,110.7846656,Buy,2
11-03-2024 07:00,110,111,110,110,22,110.787234,Sell,1
11-03-2024 06:45,112,112,109,109,81,110.8098472,Sell,3
11-03-2024 06:30,111,111,108,111,395,110.8070866,Sell,3
11-03-2024 04:15,112,112,110,110,9,112.6371681,Sell,2
11-03-2024 04:00,110,111,108,110,8,112.7692308,Sell,3
11-03-2024 03:45,108,109,108,109,4,112.96875,Buy,1
11-03-2024 03:30,108,108,108,108,3,113.1630435,Sell,0
11-03-2024 03:15,111,112,109,111,18,113.3370787,Sell,3
11-03-2024 03:00,112,112,110,110,6,113.9577465,Sell,2
11-03-2024 02:45,112,112,109,109,4,114.1692308,Sell,3
11-03-2024 02:30,115,117,112,112,61,114.442623,Sell,5
08-03-2024 09:45,120,120,116,116,164,118.7729196,Sell,4
08-03-2024 09:30,121,121,120,120,65,118.9449541,Sell,1
08-03-2024 09:15,121,121,121,121,6,118.7770833,Sell,0
08-03-2024 09:00,121,121,121,121,17,118.7489451,Sell,0
08-03-2024 08:45,122,122,121,121,11,118.6652079,Sell,1
08-03-2024 08:30,122,122,122,122,36,118.5986547,Sell,0
08-03-2024 08:15,120,121,119,121,4,118.3,Buy,2
08-03-2024 08:00,120,120,118,120,23,118.2832512,Sell,2
08-03-2024 07:45,121,121,120,120,4,118.2637076,Sell,1
08-03-2024 07:30,119,122,119,120,20,118.2427441,Buy,3
08-03-2024 07:15,119,120,117,120,35,118.097493,Buy,3
08-03-2024 07:00,117,118,117,118,10,118.0555556,Buy,1
08-03-2024 06:45,119,120,116,117,67,118.0732484,Sell,4
08-03-2024 06:30,115,119,115,117,64,118.2793522,Buy,4
08-03-2024 04:15,116,116,115,115,10,118.8306011,Sell,1
08-03-2024 04:00,117,117,115,115,10,119.0057803,Sell,2
08-03-2024 03:45,118,118,118,118,12,119.1656442,Sell,0
08-03-2024 03:30,117,118,117,118,7,119.2582781,Buy,1
08-03-2024 03:15,117,120,117,119,44,119.3541667,Buy,3
08-03-2024 03:00,117,119,114,119,41,119.73,Buy,5
08-03-2024 02:45,120,120,117,117,22,122.0847458,Sell,3
08-03-2024 02:30,124,127,123,124,30,124.2432432,Sell,4
07-03-2024 15:15,120,120,120,120,1,120.7142857,Sell,0
07-03-2024 15:00,120,120,120,120,1,120.8333333,Sell,0
07-03-2024 14:00,120,120,120,120,1,121,Sell,0
07-03-2024 13:30,120,120,120,120,2,121.25,Sell,0
07-03-2024 13:15,122,122,122,122,1,122.5,Sell,0
07-03-2024 13:00,123,123,123,123,1,123,Sell,0
07-03-2024 09:45,117,122,117,122,42,118.7153996,Buy,5
07-03-2024 09:30,121,122,121,121,22,118.4564756,Sell,1
07-03-2024 09:15,119,122,119,122,5,118.3006682,Buy,3
07-03-2024 09:00,118,119,118,119,13,118.2725225,Buy,1
07-03-2024 08:45,117,117,116,116,4,118.2552204,Sell,1
07-03-2024 08:30,116,118,116,117,8,118.2693208,Buy,2
07-03-2024 08:15,118,118,117,117,35,118.2959427,Sell,1
07-03-2024 08:00,118,118,116,116,37,118.3385417,Sell,2
07-03-2024 07:45,117,117,116,117,13,118.4726225,Sell,1
07-03-2024 07:30,120,121,117,117,39,118.5538922,Sell,4
07-03-2024 07:15,119,119,118,119,23,118.5559322,Sell,1
07-03-2024 07:00,119,120,118,119,14,118.5588235,Sell,2
07-03-2024 06:45,115,115,115,115,1,118.5387597,Sell,0
07-03-2024 06:30,115,118,114,118,18,118.5525292,Buy,4
07-03-2024 04:15,114,115,113,114,8,118.7573222,Sell,2
07-03-2024 04:00,114,114,113,114,5,118.9177489,Sell,1
07-03-2024 03:45,110,115,110,114,15,119.0353982,Buy,5
07-03-2024 03:30,109,110,109,109,16,119.492891,Sell,1
07-03-2024 03:15,116,116,110,110,29,120.2974359,Sell,6
07-03-2024 03:00,117,117,115,116,18,121.6807229,Sell,2
07-03-2024 02:45,118,118,118,118,7,122.3243243,Sell,0
07-03-2024 02:30,120,121,117,117,24,122.5390071,Sell,4
06-03-2024 15:15,121,121,121,121,1,123.3247863,Sell,0
06-03-2024 15:00,121,121,120,121,23,123.3448276,Sell,1
06-03-2024 14:30,122,122,121,121,10,123.9462366,Sell,1
06-03-2024 14:15,123,123,121,122,4,124.2650602,Sell,2
06-03-2024 14:00,123,123,121,121,5,124.3670886,Sell,2
06-03-2024 13:45,124,124,123,123,5,124.5675676,Sell,1
06-03-2024 13:30,123,124,122,122,16,124.6521739,Sell,2
06-03-2024 13:15,125,126,122,122,29,125.1698113,Sell,4
06-03-2024 13:00,128,128,126,126,24,126.875,Sell,2
06-03-2024 09:45,126,129,126,129,7,115.3543165,Buy,3
06-03-2024 09:30,127,127,127,127,2,115.2112933,Sell,0
06-03-2024 09:15,127,127,127,127,5,115.1681901,Sell,0
06-03-2024 09:00,129,129,127,127,12,115.0590406,Sell,2
06-03-2024 08:30,130,130,130,130,2,114.7641509,Sell,0
06-03-2024 08:15,131,131,131,131,2,114.7064394,Sell,0
06-03-2024 08:00,126,133,125,132,28,114.6444867,Buy,8
06-03-2024 07:45,121,125,121,125,13,113.8534137,Buy,4
06-03-2024 06:30,121,121,120,120,12,113.5917526,Sell,1
06-03-2024 04:15,119,120,119,120,12,113.4122622,Buy,1
06-03-2024 04:00,120,120,120,120,4,113.2472885,Sell,0
06-03-2024 03:30,119,120,119,120,8,113.1881838,Buy,1
06-03-2024 03:15,118,118,117,117,41,113.0690423,Sell,1
06-03-2024 03:00,116,116,115,115,5,112.6372549,Sell,1
06-03-2024 02:45,118,118,116,116,5,112.5980149,Sell,2
06-03-2024 02:30,111,120,111,118,143,112.5351759,Buy,9
05-03-2024 15:15,110,112,109,112,41,110.4,Buy,3
05-03-2024 15:00,111,112,111,112,51,110.6121495,Buy,1
05-03-2024 14:45,113,113,111,111,33,110.3680982,Sell,2
05-03-2024 14:30,110,113,108,113,30,110.1615385,Buy,5
05-03-2024 14:15,110,110,110,110,73,110.25,Sell,0
05-03-2024 14:00,110,110,110,110,4,110.9259259,Sell,0
05-03-2024 13:45,110,110,109,110,7,111.0869565,Sell,1
05-03-2024 13:30,111,111,110,110,7,111.75,Sell,1
05-03-2024 13:15,112,113,111,111,5,112.7777778,Sell,2
05-03-2024 13:00,114,114,113,114,4,113.75,Sell,1
05-03-2024 09:45,113,116,113,116,24,105.3288043,Buy,3
05-03-2024 09:30,113,113,112,112,4,104.744186,Sell,1
05-03-2024 09:15,114,114,113,113,14,104.6558824,Sell,1
05-03-2024 09:00,113,115,113,114,14,104.291411,Buy,2
05-03-2024 08:30,113,114,113,114,15,103.8621795,Buy,1
05-03-2024 08:15,109,114,109,114,67,103.3569024,Buy,5
05-03-2024 08:00,108,108,108,108,4,101.0217391,Sell,0
05-03-2024 07:30,107,108,107,108,8,100.8982301,Buy,1
05-03-2024 06:45,105,106,105,106,11,100.6559633,Buy,1
05-03-2024 06:30,106,108,106,107,22,100.4154589,Buy,2
05-03-2024 04:15,107,107,106,106,16,99.64324324,Sell,1
05-03-2024 03:45,104,106,104,106,25,98.97633136,Buy,2
05-03-2024 03:30,103,104,103,104,4,97.97222222,Buy,1
05-03-2024 02:45,95,101,93,101,30,97.82142857,Buy,8
05-03-2024 02:30,101,102,95,95,26,98.43636364,Sell,7
04-03-2024 15:15,98,100,98,99,36,97.88095238,Buy,2
04-03-2024 15:00,99,99,99,99,3,97.52083333,Sell,0
04-03-2024 14:30,99,99,99,99,4,97.42222222,Sell,0
04-03-2024 13:30,97,97,95,95,8,97.26829268,Sell,2
04-03-2024 13:15,98,98,97,97,17,97.63636364,Sell,1
04-03-2024 13:00,100,100,96,96,16,97.5,Sell,4
04-03-2024 09:45,100,100,98,99,40,101.057971,Sell,2
04-03-2024 09:30,102,102,102,102,2,102.0306122,Sell,0
04-03-2024 09:15,101,101,100,100,12,102.03125,Sell,1
04-03-2024 09:00,102,102,101,101,12,102.1904762,Sell,1
04-03-2024 08:45,102,102,102,102,2,102.3055556,Sell,0
04-03-2024 08:30,104,104,103,104,8,102.3142857,Sell,1
04-03-2024 08:15,104,105,104,105,7,102.1290323,Buy,1
04-03-2024 08:00,104,104,104,104,3,101.8,Sell,0
04-03-2024 07:45,103,103,103,103,5,101.6730769,Sell,0
04-03-2024 07:30,104,104,103,103,4,101.5319149,Sell,1
04-03-2024 07:15,103,103,103,103,2,101.372093,Sell,0
04-03-2024 03:45,102,104,102,104,9,101.2926829,Buy,2
04-03-2024 03:30,102,102,102,102,1,100.59375,Sell,0
04-03-2024 03:15,103,103,103,103,5,100.5483871,Sell,0
04-03-2024 03:00,101,102,101,102,10,100.0769231,Buy,1
04-03-2024 02:45,99,100,99,100,12,99.1875,Buy,1
04-03-2024 02:30,97,98,97,97,4,97.5,Sell,1
01-03-2024 09:45,96,99,96,97,27,94.24652778,Buy,3
01-03-2024 09:30,95,96,94,96,16,93.94252874,Buy,2
01-03-2024 09:15,93,95,92,94,29,93.87755102,Buy,3
01-03-2024 08:30,97,98,95,95,8,93.92592593,Sell,3
01-03-2024 08:15,95,95,95,95,4,93.79807692,Sell,0
01-03-2024 07:15,97,97,97,97,2,93.7745098,Sell,0
01-03-2024 07:00,96,97,96,97,54,93.74257426,Buy,1
01-03-2024 06:45,93,96,93,96,20,92.7027027,Buy,3
01-03-2024 06:30,92,92,92,92,2,92.3671875,Sell,0
01-03-2024 04:00,91,91,90,90,6,92.37301587,Sell,1
01-03-2024 03:45,92,92,91,91,14,92.45833333,Sell,1
01-03-2024 03:30,91,91,91,91,1,92.64150943,Sell,0
01-03-2024 03:15,93,93,90,90,22,92.65714286,Sell,3
01-03-2024 03:00,95,95,95,95,1,92.96385542,Sell,0
01-03-2024 02:45,93,95,93,95,3,92.93902439,Buy,2
01-03-2024 02:30,92,95,92,95,45,92.88607595,Buy,3
29-02-2024 15:15,91,91,91,91,4,90.79411765,Sell,0
29-02-2024 15:00,91,91,91,91,1,90.76666667,Sell,0
29-02-2024 14:45,91,91,91,91,20,90.75862069,Sell,0
29-02-2024 14:30,90,90,89,89,4,90.22222222,Sell,1
29-02-2024 13:45,91,91,91,91,3,90.6,Sell,0
29-02-2024 13:00,90,90,90,90,2,90,Sell,0
29-02-2024 09:45,93,93,93,93,7,93.26744186,Sell,0
29-02-2024 09:30,95,95,95,95,4,93.2749004,Sell,0
29-02-2024 09:15,93,93,93,93,2,93.24696356,Sell,0
29-02-2024 08:45,95,96,95,96,21,93.24897959,Buy,1
29-02-2024 08:30,95,95,95,95,3,93.06696429,Sell,0
29-02-2024 08:15,94,95,92,92,23,93.04072398,Sell,3
29-02-2024 08:00,92,93,92,93,8,92.97474747,Buy,1
29-02-2024 07:45,94,95,94,94,77,92.98421053,Sell,1
29-02-2024 07:30,94,94,94,94,40,92.18584071,Sell,0
29-02-2024 07:15,93,94,93,93,5,91.19178082,Sell,1
29-02-2024 07:00,92,93,92,93,6,91.02941176,Buy,1
29-02-2024 06:45,92,94,92,92,15,90.90322581,Sell,2
29-02-2024 06:30,91,91,91,91,1,90.5106383,Sell,0
29-02-2024 04:15,91,91,91,91,1,90.5,Sell,0
29-02-2024 03:30,91,91,91,91,15,90.48888889,Sell,0
29-02-2024 03:15,91,91,90,90,3,90.23333333,Sell,1
29-02-2024 03:00,91,91,91,91,4,90.18518519,Sell,0
29-02-2024 02:45,92,93,92,93,3,90.04347826,Buy,1
29-02-2024 02:30,91,92,91,92,6,89.65,Buy,1
28-02-2024 15:15,90,90,90,90,1,88.92857143,Sell,0
28-02-2024 14:30,89,89,89,89,8,88.84615385,Sell,0
28-02-2024 13:00,89,89,88,88,5,88.6,Sell,1
28-02-2024 09:45,88,90,88,88,18,88.35057471,Sell,2
28-02-2024 09:15,88,88,88,88,5,88.33974359,Sell,0
28-02-2024 09:00,88,88,88,88,2,88.35099338,Sell,0
28-02-2024 08:45,88,88,88,88,1,88.3557047,Sell,0
28-02-2024 08:30,87,87,87,87,5,88.35810811,Sell,0
28-02-2024 08:15,87,87,86,87,50,88.40559441,Sell,1
28-02-2024 08:00,87,88,87,88,14,89.23655914,Buy,1
28-02-2024 07:30,88,88,88,88,2,89.60759494,Sell,0
28-02-2024 07:15,90,90,90,90,1,89.64935065,Sell,0
28-02-2024 07:00,90,90,90,90,5,89.64473684,Sell,0
28-02-2024 06:45,91,92,91,92,10,89.61971831,Buy,1
28-02-2024 06:30,87,87,87,87,2,89.37704918,Sell,0
28-02-2024 04:00,89,89,89,89,1,89.45762712,Sell,0
28-02-2024 03:15,89,89,89,89,1,89.46551724,Sell,0
28-02-2024 02:45,88,88,87,87,20,89.47368421,Sell,1
27-02-2024 15:15,93,93,93,93,2,90.72972973,Sell,0
27-02-2024 14:30,89,91,89,91,17,90.6,Buy,2
27-02-2024 14:15,89,89,89,89,2,90.38888889,Sell,0
27-02-2024 13:30,89,92,89,89,15,90.5625,Sell,3
27-02-2024 13:15,92,92,92,92,1,92,Sell,0
27-02-2024 09:45,91,92,91,92,4,93.04918033,Buy,1
27-02-2024 09:30,93,93,92,92,5,93.06644518,Sell,1
27-02-2024 09:15,94,94,94,94,9,93.0777027,Sell,0
27-02-2024 09:00,93,95,93,94,40,93.04878049,Buy,2
27-02-2024 08:45,91,92,91,92,10,92.951417,Buy,1
27-02-2024 08:30,92,92,92,92,5,93.01265823,Sell,0
27-02-2024 08:15,93,93,92,92,2,93.03448276,Sell,1
27-02-2024 08:00,93,93,93,93,9,93.03913043,Sell,0
27-02-2024 07:45,93,93,93,93,1,93.04072398,Sell,0
27-02-2024 07:15,91,92,91,91,16,93.04090909,Sell,1
27-02-2024 06:45,90,91,90,91,15,93.19117647,Buy,1
27-02-2024 06:30,94,94,89,89,99,93.40740741,Sell,5
27-02-2024 04:15,95,95,95,95,1,95.81111111,Sell,0
27-02-2024 04:00,95,96,95,95,15,95.82022472,Sell,1
27-02-2024 03:45,94,94,94,94,2,95.94594595,Sell,0
27-02-2024 03:30,97,97,97,97,2,96,Sell,0
27-02-2024 02:30,97,97,94,95,40,95.97142857,Sell,3
26-02-2024 15:15,96,96,96,96,2,97.56666667,Sell,0
26-02-2024 15:00,98,98,96,98,8,97.67857143,Sell,2
26-02-2024 14:45,98,98,98,98,1,97.85,Sell,0
26-02-2024 14:30,97,98,97,98,5,97.84210526,Buy,1
26-02-2024 14:00,98,98,97,97,4,97.85714286,Sell,1
26-02-2024 13:30,97,97,97,97,2,98,Sell,0
26-02-2024 13:15,97,98,97,98,4,98.25,Buy,1
26-02-2024 13:00,99,99,99,99,4,99,Sell,0
26-02-2024 09:45,97,98,96,96,32,93.68273092,Sell,2
26-02-2024 09:30,96,98,95,98,12,93.44849785,Buy,3
26-02-2024 09:15,96,97,96,97,26,93.36563877,Buy,1
26-02-2024 08:45,95,96,95,96,6,93.17056075,Buy,1
26-02-2024 08:30,94,96,94,95,7,93.13270142,Buy,2
26-02-2024 08:00,94,94,94,94,1,93.09879518,Sell,0
26-02-2024 07:30,95,95,95,95,2,93.09661836,Sell,0
26-02-2024 07:15,94,95,94,94,4,93.08737864,Sell,1
26-02-2024 07:00,98,98,94,94,30,93.07598039,Sell,4
26-02-2024 06:45,95,99,95,98,92,92.78042328,Buy,4
26-02-2024 06:30,95,95,94,95,25,91.3041958,Sell,1
26-02-2024 04:15,94,94,94,94,2,90.96168582,Sell,0
26-02-2024 04:00,94,94,94,94,11,90.93822394,Sell,0
26-02-2024 03:45,93,93,93,93,3,90.80241935,Sell,0
26-02-2024 03:30,94,94,94,94,6,90.7755102,Sell,0
26-02-2024 03:15,92,93,92,93,3,90.69456067,Buy,1
26-02-2024 03:00,91,94,91,94,104,90.67372881,Buy,3
26-02-2024 02:45,91,93,89,90,34,89.39393939,Sell,4
26-02-2024 02:30,91,91,86,91,98,88.81632653,Sell,5
23-02-2024 09:45,92,93,92,93,7,90.45697329,Buy,1
23-02-2024 09:15,92,92,92,92,6,90.43328336,Sell,0
23-02-2024 09:00,89,93,89,93,42,90.41906203,Buy,4
23-02-2024 08:45,89,89,89,89,3,90.35379645,Sell,0
23-02-2024 07:30,91,91,91,91,3,90.36038961,Sell,0
23-02-2024 07:15,92,92,92,92,1,90.35725938,Sell,0
23-02-2024 07:00,92,92,91,91,47,90.35457516,Sell,1
23-02-2024 06:45,90,92,90,92,178,90.22654867,Buy,2
23-02-2024 06:30,90,90,90,90,10,89.7622739,Sell,0
23-02-2024 04:00,89,90,89,90,3,89.75596817,Buy,1
23-02-2024 03:30,89,90,89,90,62,89.75668449,Buy,1
23-02-2024 03:15,91,91,89,90,152,89.7275641,Sell,2
23-02-2024 03:00,90,91,90,91,59,89.16875,Buy,1
23-02-2024 02:45,89,90,88,90,35,88.13861386,Buy,2
23-02-2024 02:30,86,89,86,88,35,87.57575758,Buy,3
22-02-2024 15:15,89,90,89,90,2,87.22580645,Buy,1
22-02-2024 14:45,88,89,88,89,3,87.06896552,Buy,1
22-02-2024 14:15,88,88,88,88,2,86.88461538,Sell,0
22-02-2024 14:00,88,88,88,88,1,86.79166667,Sell,0
22-02-2024 13:45,87,88,87,88,10,86.73913043,Buy,1
22-02-2024 13:30,87,87,87,87,2,86.46153846,Sell,0
22-02-2024 13:15,88,88,88,88,2,86.36363636,Sell,0
22-02-2024 13:00,86,86,86,86,9,86,Sell,0
22-02-2024 09:45,89,90,88,90,28,87.83571429,Buy,2
22-02-2024 09:30,87,90,87,89,47,87.79064039,Buy,3
22-02-2024 09:15,88,88,87,87,14,87.75294118,Sell,1
22-02-2024 08:30,88,88,88,88,3,87.75898802,Sell,0
22-02-2024 08:15,88,88,88,88,19,87.75802139,Sell,0
22-02-2024 08:00,89,89,88,88,25,87.75171468,Sell,1
22-02-2024 07:45,88,88,88,88,8,87.734375,Sell,0
22-02-2024 07:30,90,90,90,90,1,87.73132184,Sell,0
22-02-2024 07:15,90,91,90,91,8,87.72805755,Buy,1
22-02-2024 07:00,91,92,90,90,65,87.69141194,Sell,2
22-02-2024 06:45,89,91,89,91,206,87.32797428,Buy,2
22-02-2024 06:30,89,89,89,89,5,85.98317308,Sell,0
22-02-2024 04:15,88,89,87,89,81,85.94647202,Buy,2
22-02-2024 04:00,88,88,88,88,5,85.28181818,Sell,0
22-02-2024 03:45,87,87,86,87,11,85.24,Sell,1
22-02-2024 03:30,88,88,88,88,32,85.18471338,Sell,0
22-02-2024 03:15,88,88,87,87,13,84.86524823,Sell,1
22-02-2024 03:00,86,88,86,88,89,84.71747212,Buy,2
22-02-2024 02:45,84,86,84,85,67,83.8,Buy,2
22-02-2024 02:30,83,84,81,84,85,83.27433628,Buy,3
21-02-2024 15:15,83,83,83,83,6,85.39285714,Sell,0
21-02-2024 14:30,87,87,84,84,3,86.04545455,Sell,3
21-02-2024 13:30,85,85,85,85,1,86.05263158,Sell,0
21-02-2024 13:15,87,87,85,85,11,86.11111111,Sell,2
21-02-2024 13:00,86,88,86,88,7,86.42857143,Buy,2
21-02-2024 09:45,89,90,88,89,272,87.70764618,Sell,2
21-02-2024 09:30,86,89,86,89,70,87.36911488,Buy,3
21-02-2024 09:15,86,88,86,88,60,87.28225806,Buy,2
21-02-2024 08:45,89,89,89,89,2,87.33369099,Sell,0
21-02-2024 08:30,88,88,88,88,7,87.33010753,Sell,0
21-02-2024 08:15,88,89,88,89,19,87.32502709,Buy,1
21-02-2024 08:00,89,89,88,88,83,87.30641593,Sell,1
21-02-2024 07:45,89,90,88,89,156,87.15712546,Sell,2
21-02-2024 07:30,91,91,89,91,68,86.84360902,Sell,2
21-02-2024 07:15,90,91,90,91,5,86.40703518,Buy,1
21-02-2024 07:00,93,94,90,90,28,86.375,Sell,4
21-02-2024 06:45,89,93,89,93,74,86.12765957,Buy,4
21-02-2024 06:30,89,90,88,88,50,85.40612245,Sell,2
21-02-2024 04:15,88,88,88,88,2,85.00454545,Sell,0
21-02-2024 04:00,86,88,86,88,4,84.99086758,Buy,2
21-02-2024 03:45,88,88,88,88,2,84.97695853,Sell,0
21-02-2024 03:30,89,89,88,88,3,84.96296296,Sell,1
21-02-2024 03:15,86,89,86,89,133,84.93706294,Buy,3
21-02-2024 03:00,84,86,84,86,124,83.73310811,Buy,2
21-02-2024 02:45,84,84,83,84,8,82.77325581,Sell,1
21-02-2024 02:30,83,84,83,84,5,82.7195122,Buy,1
20-02-2024 15:00,83,84,83,83,61,82.6918239,Sell,1
20-02-2024 14:45,84,84,84,84,1,82.42857143,Sell,0
20-02-2024 14:30,83,84,83,84,30,82.41237113,Buy,1
20-02-2024 14:15,83,83,83,83,9,82.13432836,Sell,0
20-02-2024 14:00,82,83,82,82,28,82,Sell,1
20-02-2024 13:45,81,82,81,82,14,81.9,Buy,1
20-02-2024 13:30,84,84,82,82,7,81.9375,Sell,2
20-02-2024 13:15,82,82,82,82,1,81.66666667,Sell,0
20-02-2024 13:00,82,82,81,81,8,81.625,Sell,1
20-02-2024 09:45,80,80,80,80,13,81.50672646,Sell,0
20-02-2024 09:30,81,81,81,81,1,81.55196305,Sell,0
20-02-2024 09:15,82,82,80,80,33,81.55324074,Sell,2
20-02-2024 09:00,83,83,83,83,2,81.60150376,Sell,0
20-02-2024 08:45,83,83,83,83,6,81.59445844,Sell,0
20-02-2024 08:00,83,83,83,83,16,81.57289003,Sell,0
20-02-2024 07:30,83,83,82,82,8,81.512,Sell,1
20-02-2024 07:15,83,84,83,84,28,81.49046322,Buy,1
20-02-2024 07:00,84,84,81,81,12,81.28908555,Sell,3
20-02-2024 06:45,83,84,82,84,97,81.22324159,Buy,2
20-02-2024 06:30,80,83,80,83,35,80.33478261,Buy,3
20-02-2024 03:15,82,82,82,82,24,79.91282051,Sell,0
20-02-2024 03:00,82,82,82,82,6,79.61988304,Sell,0
20-02-2024 02:45,81,82,80,80,13,79.53333333,Sell,2
20-02-2024 02:30,79,82,78,81,134,79.39473684,Buy,4
19-02-2024 14:45,79,79,79,79,1,81.05555556,Sell,0
19-02-2024 14:30,80,80,80,80,4,81.17647059,Sell,0
19-02-2024 14:00,80,80,80,80,6,81.53846154,Sell,0
19-02-2024 13:30,80,80,80,80,1,82.85714286,Sell,0
19-02-2024 13:15,83,84,83,84,5,83.33333333,Buy,1
19-02-2024 13:00,81,81,81,81,1,81,Sell,0
19-02-2024 09:45,83,84,81,81,19,80.56185567,Sell,3
19-02-2024 09:15,84,84,84,84,1,80.45257453,Sell,0
19-02-2024 09:00,80,83,80,82,29,80.44293478,Buy,3
19-02-2024 08:45,82,82,82,82,13,80.30678466,Sell,0
19-02-2024 08:30,82,82,80,80,9,80.2392638,Sell,2
19-02-2024 08:00,79,79,79,79,4,80.20189274,Sell,0
19-02-2024 07:45,81,82,81,82,13,80.2172524,Buy,1
19-02-2024 07:30,80,81,80,81,59,80.14333333,Buy,1
19-02-2024 07:15,80,81,80,80,19,80.08298755,Sell,1
19-02-2024 07:00,80,82,80,81,53,80.02702703,Buy,2
19-02-2024 06:45,80,80,80,80,30,79.92307692,Sell,0
19-02-2024 06:30,79,81,78,80,50,79.90647482,Buy,3
19-02-2024 04:15,77,77,77,77,8,79.93258427,Sell,0
19-02-2024 03:45,79,79,79,79,1,80.22222222,Sell,0
19-02-2024 03:15,79,79,78,78,2,80.2375,Sell,1
19-02-2024 03:00,80,80,80,80,2,80.28205128,Sell,0
19-02-2024 02:45,82,82,77,78,26,80.28947368,Sell,5
19-02-2024 02:30,85,85,79,80,50,81.38,Sell,6
16-02-2024 09:45,85,85,82,83,68,83.91317365,Sell,3
16-02-2024 09:30,82,85,82,85,32,83.99166667,Buy,3
16-02-2024 09:15,83,83,83,83,18,83.99471831,Sell,0
16-02-2024 09:00,83,84,83,83,54,84.02727273,Sell,1
16-02-2024 08:15,82,83,82,82,21,84.13709677,Sell,1
16-02-2024 07:45,82,82,82,82,4,84.20421053,Sell,0
16-02-2024 07:15,83,83,80,81,28,84.22292994,Sell,3
16-02-2024 07:00,84,84,83,83,17,84.4221219,Sell,1
16-02-2024 06:45,84,84,84,84,5,84.4600939,Sell,0
16-02-2024 06:30,83,84,83,84,3,84.46555819,Buy,1
16-02-2024 04:15,83,83,83,83,3,84.47129187,Sell,0
16-02-2024 04:00,82,83,82,83,24,84.48192771,Buy,1
16-02-2024 03:45,83,83,82,83,10,84.57544757,Sell,1
16-02-2024 03:30,83,83,82,82,28,84.6351706,Sell,1
16-02-2024 03:15,82,83,82,83,7,84.77053824,Buy,1
16-02-2024 03:00,83,83,83,83,2,84.82369942,Sell,0
16-02-2024 02:45,83,83,83,83,1,84.83430233,Sell,0
16-02-2024 02:30,80,83,80,83,22,84.83965015,Buy,3
15-02-2024 15:00,82,82,82,82,2,85.11214953,Sell,0
15-02-2024 14:00,85,86,85,85,97,85.13166144,Sell,1
15-02-2024 13:45,85,88,85,85,222,85.15315315,Sell,3
15-02-2024 09:45,86,88,85,87,18,84.35471698,Buy,3
15-02-2024 09:30,83,85,81,85,16,84.21052632,Buy,4
15-02-2024 08:45,87,87,86,87,19,84.34199134,Sell,1
15-02-2024 08:30,86,87,86,87,21,84.1509434,Buy,1
15-02-2024 08:15,87,87,87,87,2,83.91623037,Sell,0
15-02-2024 08:00,86,87,85,86,12,83.88359788,Sell,2
15-02-2024 07:45,86,87,84,87,18,83.75706215,Buy,3
15-02-2024 07:30,85,87,84,84,16,83.49685535,Sell,3
15-02-2024 07:00,84,84,84,84,1,83.32167832,Sell,0
15-02-2024 06:45,82,82,79,81,31,83.31690141,Sell,3
15-02-2024 06:30,83,83,80,80,19,84.0990991,Sell,3
15-02-2024 03:00,85,85,85,85,1,84.65217391,Sell,0
15-02-2024 02:45,85,85,85,85,3,84.64835165,Sell,0
15-02-2024 02:30,86,86,84,85,9,84.63636364,Sell,2
14-02-2024 15:15,87,87,86,86,14,84.56962025,Sell,1
14-02-2024 14:15,85,86,85,86,23,84.09230769,Buy,1
14-02-2024 14:00,84,85,84,85,17,83.52380952,Buy,1
14-02-2024 13:45,83,83,83,83,1,83.08,Sell,0
14-02-2024 13:15,84,84,83,83,6,83.08333333,Sell,1
14-02-2024 13:00,83,84,83,84,18,83.05555556,Buy,1
14-02-2024 09:45,81,81,80,80,9,75.63660477,Sell,1
14-02-2024 09:30,80,80,80,80,5,75.51902174,Sell,0
14-02-2024 09:15,82,82,82,82,1,75.45730028,Sell,0
14-02-2024 08:30,82,82,82,82,1,75.43922652,Sell,0
14-02-2024 08:00,81,81,79,79,5,75.42105263,Sell,2
14-02-2024 07:45,82,82,82,82,2,75.35393258,Sell,0
14-02-2024 07:00,82,82,80,82,22,75.31638418,Sell,2
14-02-2024 06:45,79,82,79,82,54,74.90361446,Buy,3
14-02-2024 06:30,80,80,77,79,47,73.89568345,Sell,3
14-02-2024 04:15,77,80,77,80,32,73.01298701,Buy,3
14-02-2024 03:45,77,77,77,77,3,72.15577889,Sell,0
14-02-2024 03:30,77,78,77,77,22,72.08163265,Sell,1
14-02-2024 03:15,77,77,76,76,4,71.39655172,Sell,1
14-02-2024 03:00,73,75,73,75,63,71.27058824,Buy,2
14-02-2024 02:45,71,73,70,73,29,70.06542056,Buy,3
14-02-2024 02:30,72,74,71,73,14,69.62820513,Buy,3
13-02-2024 15:00,69,69,69,69,7,68.921875,Sell,0
13-02-2024 14:30,69,69,69,69,13,68.9122807,Sell,0
13-02-2024 13:30,69,69,68,68,20,68.88636364,Sell,1
13-02-2024 13:15,69,69,69,69,24,69,Sell,0
13-02-2024 09:45,68,70,67,67,134,63.96472663,Sell,3
13-02-2024 09:30,68,68,67,67,10,62.93764434,Sell,1
13-02-2024 09:15,67,67,67,67,21,62.8250591,Sell,0
13-02-2024 09:00,65,66,65,66,47,62.60696517,Buy,1
13-02-2024 08:45,63,65,63,65,7,62.22253521,Buy,2
13-02-2024 08:30,65,66,62,63,22,62.19252874,Sell,4
13-02-2024 08:15,65,66,64,65,12,62.09815951,Sell,2
13-02-2024 08:00,63,65,63,65,4,61.98726115,Buy,2
13-02-2024 07:45,65,66,64,64,32,61.96774194,Sell,2
13-02-2024 07:30,65,65,65,65,6,61.62589928,Sell,0
13-02-2024 07:15,65,65,64,65,9,61.55147059,Sell,1
13-02-2024 07:00,65,65,65,65,18,61.45247148,Sell,0
13-02-2024 06:45,63,65,63,65,40,61.19183673,Buy,2
13-02-2024 06:30,60,64,60,64,177,60.64878049,Buy,4
13-02-2024 04:15,60,60,60,60,2,58.75,Sell,0
13-02-2024 04:00,60,60,59,60,4,58.65384615,Sell,1
13-02-2024 03:45,59,59,59,59,4,58.45454545,Sell,0
13-02-2024 03:15,58,59,58,59,7,58.33333333,Buy,1
13-02-2024 03:00,59,59,59,59,5,58.18181818,Sell,0
13-02-2024 02:45,58,59,58,59,4,57.5,Buy,1
13-02-2024 02:30,57,57,55,55,2,56,Sell,2
09-02-2024 09:45,57,60,54,60,40,57.18435754,Buy,6
09-02-2024 08:45,54,54,54,54,1,57.04316547,Sell,0
09-02-2024 08:30,52,52,52,52,3,57.06521739,Sell,0
09-02-2024 07:45,54,54,54,54,1,57.17777778,Sell,0
09-02-2024 07:30,52,52,52,52,1,57.20149254,Sell,0
09-02-2024 07:15,55,55,53,53,53,57.2406015,Sell,2
09-02-2024 07:00,57,57,56,56,6,59.6625,Sell,1
09-02-2024 06:45,56,56,55,55,5,59.94594595,Sell,1
09-02-2024 06:30,60,60,55,55,23,60.28985507,Sell,5
09-02-2024 04:15,62,62,60,60,8,61.95652174,Sell,2
09-02-2024 03:45,60,61,60,61,9,62.13157895,Buy,1
09-02-2024 03:30,62,62,60,60,6,62.72413793,Sell,2
09-02-2024 03:15,62,62,62,62,7,63.17391304,Sell,0
09-02-2024 03:00,64,64,64,64,2,63.6875,Sell,0
09-02-2024 02:45,66,66,64,64,4,63.64285714,Sell,2
09-02-2024 02:30,63,67,63,67,6,63.1,Buy,4
08-02-2024 15:00,60,61,60,61,2,60.25,Buy,1
08-02-2024 14:45,60,60,60,60,1,60,Sell,0
08-02-2024 13:00,60,60,60,60,1,60,Sell,0
08-02-2024 09:45,61,61,58,58,37,59.39005736,Sell,3
08-02-2024 09:00,63,63,63,63,9,59.32921811,Sell,0
08-02-2024 08:45,62,62,62,62,5,59.25995807,Sell,0
08-02-2024 08:30,62,63,62,63,11,59.2309322,Buy,1
08-02-2024 08:15,64,66,64,65,28,59.16052061,Buy,2
08-02-2024 07:45,63,63,63,63,2,58.82678984,Sell,0
08-02-2024 07:30,61,64,61,63,58,58.80742459,Buy,3
08-02-2024 07:15,61,62,61,62,12,58.15817694,Buy,1
08-02-2024 07:00,61,61,61,61,12,58.04709141,Sell,0
08-02-2024 06:45,60,60,58,59,44,57.94555874,Sell,2
08-02-2024 06:30,59,61,59,61,53,57.70491803,Buy,2
08-02-2024 04:15,58,58,57,57,21,57.25,Sell,1
08-02-2024 04:00,58,58,58,58,10,57.18614719,Sell,0
08-02-2024 03:45,58,58,58,58,40,57.14932127,Sell,0
08-02-2024 03:30,57,58,57,57,6,56.96132597,Sell,1
08-02-2024 03:15,59,59,58,58,30,56.94857143,Sell,1
08-02-2024 03:00,59,61,58,60,19,56.55172414,Buy,3
08-02-2024 02:45,55,59,55,59,43,56.06349206,Buy,4
08-02-2024 02:30,57,58,55,55,8,55.59036145,Sell,3
07-02-2024 15:15,55,55,55,55,4,55.49333333,Sell,0
07-02-2024 15:00,52,52,52,52,3,55.52112676,Sell,0
07-02-2024 14:30,58,58,52,52,33,55.67647059,Sell,6
07-02-2024 14:15,57,57,57,57,2,56.68571429,Sell,0
07-02-2024 14:00,56,56,56,56,1,56.66666667,Sell,0
07-02-2024 13:45,57,57,56,56,11,56.6875,Sell,1
07-02-2024 13:30,57,57,56,56,15,56.85714286,Sell,1
07-02-2024 13:15,58,59,58,58,6,58.16666667,Sell,1
07-02-2024 09:45,61,61,57,59,52,60.99112426,Sell,4
07-02-2024 09:30,61,62,60,61,71,61.10897436,Sell,2
07-02-2024 09:15,61,61,61,61,1,61.07594937,Sell,0
07-02-2024 09:00,61,62,61,61,5,61.07608696,Sell,1
07-02-2024 08:45,62,62,62,62,7,61.0749543,Sell,0
07-02-2024 08:30,61,62,60,62,20,61.06296296,Buy,2
07-02-2024 08:15,62,62,61,61,11,61.08846154,Sell,1
07-02-2024 08:00,61,63,61,63,6,61.07858546,Buy,2
07-02-2024 07:45,62,63,61,61,19,61.07554672,Sell,2
07-02-2024 07:30,62,63,61,62,34,61.04958678,Sell,2
07-02-2024 07:15,64,64,63,63,17,60.96444444,Sell,1
07-02-2024 07:00,64,66,64,64,68,60.87066975,Sell,2
07-02-2024 06:45,62,64,60,64,24,60.08767123,Buy,4
07-02-2024 06:30,61,61,61,61,5,59.92961877,Sell,0
07-02-2024 04:15,60,61,60,61,11,59.91369048,Buy,1
07-02-2024 04:00,59,59,59,59,2,59.90461538,Sell,0
07-02-2024 03:45,60,60,58,60,23,59.91021672,Sell,2
07-02-2024 03:30,60,60,60,60,48,59.93666667,Sell,0
07-02-2024 03:15,59,60,59,60,97,59.92460317,Buy,1
07-02-2024 03:00,56,59,56,59,50,59.94193548,Buy,3
07-02-2024 02:45,56,57,56,57,9,60.88571429,Buy,1
07-02-2024 02:30,60,60,56,56,7,61.30208333,Sell,4
06-02-2024 15:15,62,62,61,62,30,61.53932584,Sell,1
06-02-2024 15:00,60,62,60,62,38,61.3220339,Buy,2
06-02-2024 14:45,59,59,59,59,1,60.61904762,Sell,0
06-02-2024 14:30,61,61,60,60,2,60.7,Sell,1
06-02-2024 14:15,60,60,60,60,2,60.72222222,Sell,0
06-02-2024 13:45,61,61,61,61,10,60.8125,Sell,0
06-02-2024 13:30,61,61,61,61,1,60.5,Sell,0
06-02-2024 13:00,61,61,59,59,5,60.4,Sell,2
