Timestamp,Open,High,Low,Close,Volume,VWAP,Type,Range
16-04-2024 09:45,121,122,117,117,53,124.5220588,Sell,5
16-04-2024 09:30,120,122,120,122,9,124.9531568,Buy,2
16-04-2024 09:00,122,123,122,123,3,125.0352697,Buy,1
16-04-2024 08:45,124,124,122,122,20,125.0521921,Sell,2
16-04-2024 08:30,128,128,125,125,23,125.1372549,Sell,3
16-04-2024 08:15,128,128,128,128,1,125.1192661,Sell,0
16-04-2024 08:00,127,127,127,127,5,125.1126437,Sell,0
16-04-2024 07:45,129,129,127,127,3,125.0906977,Sell,2
16-04-2024 07:30,127,127,127,127,1,125.0679157,Sell,0
16-04-2024 07:15,132,132,127,127,14,125.0633803,Sell,5
16-04-2024 07:00,130,133,130,133,28,124.8762136,Buy,3
16-04-2024 06:45,127,130,126,130,40,124.4010417,Buy,4
16-04-2024 06:30,125,126,124,126,13,124.0377907,Buy,2
16-04-2024 04:15,126,128,126,128,10,124,Buy,2
16-04-2024 04:00,126,126,125,126,7,123.9096573,Sell,1
16-04-2024 03:45,130,130,127,127,13,123.8726115,Sell,3
16-04-2024 03:30,128,128,127,128,9,123.6677741,Sell,1
16-04-2024 03:15,123,127,123,127,13,123.5547945,Buy,4
16-04-2024 03:00,122,126,121,126,72,123.4659498,Buy,5
16-04-2024 02:45,124,125,121,122,79,123.1449275,Sell,4
16-04-2024 02:30,123,127,120,125,78,123.53125,Buy,7
15-04-2024 15:00,121,121,121,121,1,123.34,Sell,0
15-04-2024 14:45,123,123,123,123,1,123.3877551,Sell,0
15-04-2024 14:30,122,122,122,122,1,123.3958333,Sell,0
15-04-2024 14:15,122,122,121,121,6,123.4255319,Sell,1
15-04-2024 14:00,121,121,121,121,1,123.7560976,Sell,0
15-04-2024 13:45,124,124,120,120,17,123.825,Sell,4
15-04-2024 13:30,122,122,122,122,4,125.5652174,Sell,0
15-04-2024 13:15,122,123,122,123,2,126.3157895,Buy,1
15-04-2024 13:00,131,131,124,124,17,126.7647059,Sell,7
15-04-2024 09:45,128,131,127,131,69,128.2511292,Buy,4
15-04-2024 09:30,125,128,125,128,25,128.234104,Buy,3
15-04-2024 09:15,124,124,122,124,15,128.2685094,Sell,2
15-04-2024 09:00,125,125,125,125,1,128.3436874,Sell,0
15-04-2024 08:45,124,129,124,129,170,128.3470411,Buy,5
15-04-2024 08:30,122,125,120,124,52,128.6747279,Buy,5
15-04-2024 08:15,122,122,122,122,2,129.0722581,Sell,0
15-04-2024 08:00,123,123,120,123,56,129.0905563,Sell,3
15-04-2024 07:45,125,127,123,124,36,129.6052999,Sell,4
15-04-2024 07:30,127,127,125,125,33,129.8619677,Sell,2
15-04-2024 07:15,130,133,127,129,33,130.0679012,Sell,6
15-04-2024 07:00,132,133,130,133,53,130.0195122,Buy,3
15-04-2024 06:45,134,134,131,131,23,129.8451957,Sell,3
15-04-2024 06:30,124,134,122,134,130,129.690167,Buy,12
15-04-2024 04:15,124,125,123,124,41,129.6577017,Sell,2
15-04-2024 04:00,123,123,122,122,10,130.2146739,Sell,1
15-04-2024 03:45,125,125,124,124,22,130.4413408,Sell,1
15-04-2024 03:30,126,126,125,125,76,130.8005952,Sell,1
15-04-2024 03:15,129,130,126,127,113,132.45,Sell,4
15-04-2024 03:00,132,132,130,130,19,136.8435374,Sell,2
15-04-2024 02:45,134,134,132,132,31,137.765625,Sell,2
15-04-2024 02:30,140,144,134,135,97,139.3092784,Sell,10
12-04-2024 09:45,145,148,142,142,77,138.2201566,Sell,6
12-04-2024 09:30,143,146,141,146,124,137.7164021,Buy,5
12-04-2024 09:15,140,144,140,144,50,136.7429963,Buy,4
12-04-2024 09:00,139,140,137,139,10,136.4319066,Sell,3
12-04-2024 08:45,137,139,136,139,58,136.3994744,Buy,3
12-04-2024 08:30,138,139,136,139,78,136.2788051,Buy,3
12-04-2024 08:15,138,138,136,136,16,136.0496,Sell,2
12-04-2024 08:00,136,137,136,137,13,136.0197044,Buy,1
12-04-2024 07:45,136,136,136,136,9,136.0134228,Sell,0
12-04-2024 07:30,135,136,133,136,46,136.0136286,Buy,3
12-04-2024 07:15,135,135,135,135,2,136.1256932,Sell,0
12-04-2024 07:00,134,135,134,134,7,136.1298701,Sell,1
12-04-2024 06:45,134,135,134,135,39,136.156015,Buy,1
12-04-2024 06:30,133,136,133,135,97,136.3022312,Buy,3
12-04-2024 04:15,135,135,135,135,7,136.6919192,Sell,0
12-04-2024 04:00,134,134,132,132,13,136.722365,Sell,2
12-04-2024 03:45,134,134,133,133,3,136.8643617,Sell,1
12-04-2024 03:30,135,135,135,135,10,136.8927614,Sell,0
12-04-2024 03:15,131,134,131,134,40,136.9449036,Buy,3
12-04-2024 03:00,136,138,132,133,84,137.625387,Sell,6
12-04-2024 02:45,137,139,134,136,104,138.8870293,Sell,5
12-04-2024 02:30,148,148,136,138,135,141.1481481,Sell,12
09-04-2024 09:45,147,147,146,146,32,147.5595794,Sell,1
09-04-2024 09:15,150,150,149,149,3,147.6007282,Sell,1
09-04-2024 09:00,152,152,152,152,5,147.593179,Sell,0
09-04-2024 08:45,151,151,151,151,14,147.5661765,Sell,0
09-04-2024 08:30,149,150,149,150,24,147.5062344,Buy,1
09-04-2024 08:00,148,150,147,150,12,147.4318766,Buy,3
09-04-2024 07:30,150,150,150,150,6,147.4099217,Sell,0
09-04-2024 07:15,149,150,149,149,38,147.3894737,Sell,1
09-04-2024 07:00,148,149,147,149,7,147.2617729,Buy,2
09-04-2024 06:45,150,150,146,149,84,147.2517483,Sell,4
09-04-2024 06:30,150,150,144,148,104,147.1473851,Sell,6
09-04-2024 04:15,147,150,147,150,36,147.1271347,Buy,3
09-04-2024 04:00,147,148,147,147,24,146.9959267,Sell,1
09-04-2024 03:45,143,147,143,147,58,146.9528908,Buy,4
09-04-2024 03:30,143,144,142,142,52,147.0929095,Sell,2
09-04-2024 03:15,145,146,143,144,59,147.767507,Sell,3
09-04-2024 03:00,146,148,145,145,67,148.4228188,Sell,3
09-04-2024 02:45,145,147,143,144,72,148.9307359,Sell,4
09-04-2024 02:30,151,153,147,147,98,151.0566038,Sell,6
08-04-2024 15:15,151,152,151,152,17,152.5409836,Buy,1
08-04-2024 14:45,153,154,153,154,4,153.1136364,Buy,1
08-04-2024 14:30,153,153,153,153,2,153.05,Sell,0
08-04-2024 14:15,152,153,152,153,9,153.0526316,Buy,1
08-04-2024 14:00,154,155,151,151,17,153.3103448,Sell,4
08-04-2024 13:45,152,153,152,153,2,153,Buy,1
08-04-2024 13:30,155,155,155,155,3,153.1,Sell,0
08-04-2024 13:15,153,153,153,153,1,152.2857143,Sell,0
08-04-2024 13:00,154,154,151,153,6,152.1666667,Sell,3
08-04-2024 09:45,152,153,151,153,48,149.2638165,Buy,2
08-04-2024 09:30,151,151,151,151,5,149.1053787,Sell,0
08-04-2024 09:15,147,150,147,150,25,149.0949227,Buy,3
08-04-2024 08:45,152,152,147,149,173,149.0998865,Sell,5
08-04-2024 08:30,150,152,150,152,39,149.1327684,Buy,2
08-04-2024 08:15,151,153,151,151,34,149.0478326,Sell,2
08-04-2024 08:00,149,152,149,150,21,148.919685,Buy,3
08-04-2024 07:45,150,150,148,150,3,148.8517915,Sell,2
08-04-2024 07:30,145,150,145,149,40,148.8494272,Buy,5
08-04-2024 07:15,146,146,146,146,4,148.9299475,Sell,0
08-04-2024 07:00,146,147,146,147,2,148.9506173,Buy,1
08-04-2024 06:45,147,150,147,147,41,148.959292,Sell,3
08-04-2024 06:30,149,150,145,147,129,149.0019084,Sell,5
08-04-2024 04:15,155,156,149,149,66,149.4126582,Sell,7
08-04-2024 04:00,159,160,156,156,48,148.7264438,Sell,4
08-04-2024 03:45,147,159,147,159,95,146.9466192,Buy,12
08-04-2024 03:30,146,148,146,148,9,143.7580645,Buy,2
08-04-2024 03:15,144,147,144,146,20,143.5762712,Buy,3
08-04-2024 03:00,145,147,144,145,37,143.3694268,Sell,3
08-04-2024 02:45,143,145,143,144,18,142.575,Buy,2
08-04-2024 02:30,147,147,137,140,102,142.2941176,Sell,10
05-04-2024 09:45,144,146,144,145,100,137.4632637,Buy,2
05-04-2024 09:30,145,147,144,144,70,136.8642079,Sell,3
05-04-2024 09:15,145,145,144,145,7,136.3348175,Sell,1
05-04-2024 09:00,144,144,144,144,3,136.2822581,Sell,0
05-04-2024 08:45,144,144,144,144,2,136.2614555,Sell,0
05-04-2024 08:30,139,144,139,144,95,136.2475248,Buy,5
05-04-2024 08:15,140,140,139,139,47,135.7253937,Sell,1
05-04-2024 08:00,142,142,137,139,44,135.5552116,Sell,5
05-04-2024 07:45,141,143,141,143,30,135.3686486,Buy,2
05-04-2024 07:30,140,142,140,140,18,135.1329609,Sell,2
05-04-2024 07:15,142,142,142,142,3,135.009122,Sell,0
05-04-2024 07:00,142,143,141,141,15,134.9851259,Sell,2
05-04-2024 06:45,134,140,133,140,77,134.87078,Buy,7
05-04-2024 06:30,134,134,131,134,202,134.6982097,Sell,3
05-04-2024 04:15,134,135,134,135,9,135.4862069,Buy,1
05-04-2024 04:00,134,134,133,133,7,135.4956217,Sell,1
05-04-2024 03:45,134,134,133,134,72,135.5230496,Sell,1
05-04-2024 03:30,134,134,133,134,95,135.8719512,Sell,1
05-04-2024 03:15,135,135,134,134,55,136.4005038,Sell,1
05-04-2024 03:00,135,136,134,134,14,136.7836257,Sell,2
05-04-2024 02:45,137,137,135,135,48,136.8536585,Sell,2
05-04-2024 02:30,135,136,135,136,71,137.0785714,Buy,1
04-04-2024 15:15,135,135,135,135,25,137.7416268,Sell,0
04-04-2024 15:00,135,135,135,135,21,138.1141304,Sell,0
04-04-2024 14:30,136,136,136,136,2,138.5153374,Sell,0
04-04-2024 14:15,138,138,137,137,6,138.5465839,Sell,1
04-04-2024 14:00,141,141,138,140,27,138.5935484,Sell,3
04-04-2024 13:45,140,140,140,140,2,138.4140625,Sell,0
04-04-2024 13:30,139,141,139,141,55,138.3888889,Buy,2
04-04-2024 13:15,138,138,135,138,37,137.2253521,Sell,3
04-04-2024 13:00,137,138,136,136,34,136.5,Sell,2
04-04-2024 09:45,134,140,134,140,116,140.1881668,Buy,6
04-04-2024 09:30,136,136,133,135,82,140.5191257,Sell,3
04-04-2024 09:15,134,136,134,136,52,141.2352941,Buy,2
04-04-2024 09:00,137,138,134,134,112,141.6786172,Sell,4
04-04-2024 08:30,136,137,136,137,22,142.7922272,Buy,1
04-04-2024 08:15,137,137,137,137,10,143.007728,Sell,0
04-04-2024 08:00,136,137,136,137,58,143.1020408,Buy,1
04-04-2024 07:45,139,140,136,136,59,143.806563,Sell,4
04-04-2024 07:15,141,142,136,139,24,144.4653846,Sell,6
04-04-2024 07:00,140,142,140,141,49,144.7137097,Buy,2
04-04-2024 06:45,142,142,140,140,20,145.0894855,Sell,2
04-04-2024 06:30,141,142,139,142,22,145.3138173,Buy,3
04-04-2024 04:15,139,141,139,141,15,145.545679,Buy,2
04-04-2024 04:00,140,140,138,138,21,145.7666667,Sell,2
04-04-2024 03:45,143,143,141,142,10,146.1273713,Sell,2
04-04-2024 03:30,144,145,141,142,54,146.2367688,Sell,4
04-04-2024 03:15,144,145,143,145,24,146.5672131,Buy,2
04-04-2024 03:00,148,148,143,145,127,146.747331,Sell,5
04-04-2024 02:45,147,149,147,149,30,147.7662338,Buy,2
04-04-2024 02:30,149,149,146,149,9,147.8306452,Sell,3
03-04-2024 15:15,145,146,143,146,8,147.7913043,Buy,3
03-04-2024 15:00,148,148,146,147,37,148.0560748,Sell,2
03-04-2024 14:45,149,149,148,148,4,148.4428571,Sell,1
03-04-2024 14:30,149,149,149,149,1,148.4545455,Sell,0
03-04-2024 14:15,149,150,148,148,33,148.4461538,Sell,2
03-04-2024 14:00,148,150,148,150,20,147.75,Buy,2
03-04-2024 13:45,146,147,145,147,4,145.9166667,Buy,2
03-04-2024 13:30,146,148,146,146,4,145.75,Sell,2
03-04-2024 13:15,145,145,145,145,2,145,Sell,0
03-04-2024 13:00,145,145,145,145,2,145,Sell,0
03-04-2024 09:45,150,151,143,143,156,156.1760814,Sell,8
03-04-2024 09:30,154,154,148,148,36,156.9181868,Sell,6
03-04-2024 09:15,153,155,151,153,41,157.0547095,Sell,4
03-04-2024 09:00,157,159,153,154,38,157.1385681,Sell,6
03-04-2024 08:45,152,157,151,157,35,157.1894923,Buy,6
03-04-2024 08:30,147,148,147,147,20,157.2628089,Sell,1
03-04-2024 08:15,146,147,146,146,26,157.3868212,Sell,1
03-04-2024 08:00,143,146,141,145,46,157.567266,Buy,5
03-04-2024 07:45,141,147,141,143,197,158.0070198,Buy,6
03-04-2024 07:30,148,148,140,141,145,159.9313869,Sell,8
03-04-2024 07:15,157,157,148,148,229,161.8963265,Sell,9
03-04-2024 07:00,159,160,155,158,237,164.0983936,Sell,5
03-04-2024 06:45,163,164,159,159,79,166.1264822,Sell,5
03-04-2024 06:30,163,165,161,162,45,166.6602941,Sell,4
03-04-2024 04:15,161,163,160,162,72,166.919685,Buy,3
03-04-2024 04:00,163,163,162,162,35,167.6980462,Sell,1
03-04-2024 03:45,165,165,164,164,19,168.0738636,Sell,1
03-04-2024 03:30,168,168,165,165,47,168.1925344,Sell,3
03-04-2024 03:15,168,171,168,170,51,168.3831169,Buy,3
03-04-2024 03:00,164,173,164,169,81,168.1751825,Buy,9
03-04-2024 02:45,167,168,164,164,62,167.7848485,Sell,4
03-04-2024 02:30,168,171,166,167,88,168.4253731,Sell,5
02-04-2024 15:15,169,169,167,167,11,168.3166667,Sell,2
02-04-2024 14:45,169,169,167,167,5,168.2840237,Sell,2
02-04-2024 14:30,168,168,166,166,3,168.2743902,Sell,2
02-04-2024 14:15,165,165,165,165,1,168.2919255,Sell,0
02-04-2024 14:00,167,168,165,168,15,168.3125,Buy,3
02-04-2024 13:45,170,171,166,166,77,168.5241379,Sell,5
02-04-2024 13:30,170,171,168,170,29,169.4264706,Sell,3
02-04-2024 13:15,168,170,167,169,26,168.8717949,Buy,3
02-04-2024 13:00,167,171,167,169,13,169.2307692,Buy,4
02-04-2024 09:45,161,167,161,166,103,162.0442308,Buy,6
02-04-2024 09:30,159,160,158,160,29,161.3381295,Buy,2
02-04-2024 09:15,160,162,159,159,30,161.4948454,Sell,3
02-04-2024 09:00,159,159,159,159,16,161.547486,Sell,0
02-04-2024 08:45,159,160,159,160,26,161.6666667,Buy,1
02-04-2024 08:30,158,158,157,157,28,161.8101266,Sell,1
02-04-2024 08:15,160,160,160,160,3,162.2083333,Sell,0
02-04-2024 08:00,161,161,158,158,4,162.2315789,Sell,3
02-04-2024 07:45,161,161,161,161,12,162.2775801,Sell,0
02-04-2024 07:30,162,163,160,160,19,162.3345725,Sell,3
02-04-2024 07:15,164,164,163,163,2,162.392,Sell,1
02-04-2024 07:00,164,165,163,163,25,162.3830645,Sell,2
02-04-2024 06:45,159,163,159,163,14,162.2421525,Buy,4
02-04-2024 06:30,156,159,156,158,21,162.291866,Buy,3
02-04-2024 04:15,159,159,157,157,32,162.8351064,Sell,2
02-04-2024 04:00,160,160,160,160,3,163.724359,Sell,0
02-04-2024 03:45,162,162,160,160,32,163.7973856,Sell,2
02-04-2024 03:30,162,164,161,164,17,164.5123967,Buy,3
02-04-2024 03:15,165,166,163,163,28,164.875,Sell,3
02-04-2024 03:00,163,165,163,165,6,164.9868421,Buy,2
02-04-2024 02:45,165,166,163,163,23,165.0857143,Sell,3
02-04-2024 02:30,167,167,164,166,26,165.3191489,Sell,3
01-04-2024 15:15,164,166,164,166,6,164.8571429,Buy,2
01-04-2024 14:30,165,165,165,165,1,164.9333333,Sell,0
01-04-2024 13:45,165,165,165,165,13,164.9285714,Sell,0
01-04-2024 13:00,164,164,164,164,1,164,Sell,0
01-04-2024 09:45,166,168,166,168,32,169.0162162,Buy,2
01-04-2024 09:30,161,165,161,165,31,169.0940649,Buy,4
01-04-2024 09:15,159,160,159,160,10,169.3190255,Buy,1
01-04-2024 09:00,159,161,159,161,4,169.4389671,Buy,2
01-04-2024 08:45,159,159,159,159,1,169.4823113,Sell,0
01-04-2024 08:30,158,160,158,158,32,169.4946871,Sell,2
01-04-2024 08:15,160,160,157,158,52,169.9153374,Sell,3
01-04-2024 08:00,163,163,160,161,37,170.7208388,Sell,3
01-04-2024 07:45,162,166,161,163,67,171.1735537,Buy,5
01-04-2024 07:30,169,169,163,163,82,171.9787557,Sell,6
01-04-2024 07:15,169,170,168,168,63,172.864818,Sell,2
01-04-2024 07:00,170,170,169,169,112,173.3190661,Sell,1
01-04-2024 06:45,169,171,168,171,39,174.261194,Buy,3
01-04-2024 06:30,180,180,167,169,88,174.7961433,Sell,13
01-04-2024 04:15,178,178,178,178,12,175.1454545,Sell,0
01-04-2024 04:00,177,178,177,178,29,175.0152091,Buy,1
01-04-2024 03:45,176,176,176,176,1,174.6623932,Sell,0
01-04-2024 03:30,175,176,175,176,6,174.6566524,Buy,1
01-04-2024 03:15,176,177,176,177,14,174.6431718,Buy,1
01-04-2024 03:00,179,180,177,177,14,174.5211268,Sell,3
01-04-2024 02:45,177,179,176,177,34,174.2462312,Sell,3
01-04-2024 02:30,169,177,169,177,165,173.5878788,Buy,8
29-03-2024 09:45,165,166,163,166,26,165.0069767,Buy,3
29-03-2024 09:30,166,166,166,166,16,164.990099,Sell,0
29-03-2024 09:15,167,167,167,167,10,164.9484536,Sell,0
29-03-2024 08:45,166,166,166,166,3,164.8941799,Sell,0
29-03-2024 08:15,165,165,163,163,14,164.8853333,Sell,2
29-03-2024 07:45,163,165,163,165,7,164.9473684,Buy,2
29-03-2024 07:30,164,164,163,163,6,164.9519774,Sell,1
29-03-2024 07:15,164,166,164,166,13,164.9712644,Buy,2
29-03-2024 07:00,165,167,164,165,71,164.9492537,Sell,3
29-03-2024 06:45,165,166,163,163,10,164.6666667,Sell,3
29-03-2024 06:30,166,167,165,167,18,164.6889764,Buy,2
29-03-2024 04:15,162,163,160,163,24,164.5720339,Buy,3
29-03-2024 04:00,161,163,161,163,4,164.8160377,Buy,2
29-03-2024 03:45,163,163,163,163,1,164.875,Sell,0
29-03-2024 03:30,160,163,160,163,10,164.884058,Buy,3
29-03-2024 03:15,164,164,157,158,73,165.0456853,Sell,7
29-03-2024 03:00,168,168,164,165,51,168.2983871,Sell,4
29-03-2024 02:45,168,171,167,169,23,170.1643836,Buy,4
29-03-2024 02:30,171,176,167,170,50,171.02,Sell,9
27-03-2024 09:45,176,176,172,173,55,178.2531987,Sell,4
27-03-2024 09:30,176,176,175,176,6,178.4370629,Sell,1
27-03-2024 09:15,180,180,175,175,67,178.448736,Sell,5
27-03-2024 08:45,180,180,180,180,2,178.4900516,Sell,0
27-03-2024 08:30,180,180,180,180,63,178.4878229,Sell,0
27-03-2024 08:15,179,180,178,178,19,178.4140867,Sell,2
27-03-2024 08:00,179,179,179,179,39,178.3974863,Sell,0
27-03-2024 07:45,177,179,177,178,21,178.3784441,Buy,2
27-03-2024 07:30,178,178,174,178,199,178.3751031,Sell,4
27-03-2024 07:15,177,179,177,179,29,178.8934911,Buy,2
27-03-2024 07:00,178,178,177,177,5,178.9116751,Sell,1
27-03-2024 06:45,178,179,176,178,20,178.9204082,Sell,3
27-03-2024 06:30,180,180,176,176,182,178.9677083,Sell,4
27-03-2024 04:15,180,180,178,178,24,179.2840617,Sell,2
27-03-2024 04:00,180,181,179,179,19,179.3169761,Sell,2
27-03-2024 03:45,177,179,177,179,23,179.3020408,Buy,2
27-03-2024 03:30,177,177,177,177,3,179.3581461,Sell,0
27-03-2024 03:15,175,178,175,178,47,179.3681241,Buy,3
27-03-2024 03:00,179,179,175,176,128,179.602719,Sell,4
27-03-2024 02:45,179,182,179,179,250,180.1797753,Sell,3
27-03-2024 02:30,180,180,178,179,19,180.9225352,Sell,2
26-03-2024 15:15,179,180,179,180,3,181.0641509,Buy,1
26-03-2024 15:00,181,181,180,180,7,181.0839695,Sell,1
26-03-2024 14:45,180,180,180,180,4,181.1058824,Sell,0
26-03-2024 14:30,180,180,179,179,57,181.123506,Sell,1
26-03-2024 14:15,181,181,181,181,13,181.5051546,Sell,0
26-03-2024 14:00,181,181,181,181,6,181.5414365,Sell,0
26-03-2024 13:45,181,181,180,180,17,181.56,Sell,1
26-03-2024 13:30,181,181,180,180,28,181.7025316,Sell,1
26-03-2024 13:15,182,183,181,181,129,181.9923077,Sell,2
26-03-2024 13:00,180,180,180,180,1,180,Sell,0
26-03-2024 09:45,180,180,180,180,61,180.5685976,Sell,0
26-03-2024 09:15,179,179,179,179,1,180.6268908,Sell,0
26-03-2024 09:00,180,180,180,180,1,180.6296296,Sell,0
26-03-2024 08:45,180,180,180,180,3,180.6306914,Sell,0
26-03-2024 08:15,180,181,180,181,8,180.6338983,Buy,1
26-03-2024 08:00,182,182,181,181,5,180.6323024,Sell,1
26-03-2024 07:45,179,182,179,182,40,180.6221837,Buy,3
26-03-2024 07:30,181,181,180,180,6,180.6778399,Sell,1
26-03-2024 07:15,180,181,180,181,9,180.6836158,Buy,1
26-03-2024 07:00,180,181,180,181,20,180.6915709,Buy,1
26-03-2024 06:45,179,180,179,180,2,180.7111554,Buy,1
26-03-2024 06:30,181,181,178,181,36,180.716,Sell,3
26-03-2024 04:15,183,185,183,184,52,180.8491379,Buy,2
26-03-2024 04:00,182,183,181,181,43,180.5169903,Sell,2
26-03-2024 03:45,181,182,180,182,64,180.3794038,Buy,2
26-03-2024 03:30,177,182,177,179,36,180.1114754,Buy,5
26-03-2024 03:15,177,177,177,177,2,180.1486989,Sell,0
26-03-2024 03:00,177,177,176,176,20,180.1722846,Sell,1
26-03-2024 02:45,179,179,175,177,70,180.4777328,Sell,4
26-03-2024 02:30,179,183,178,180,60,181.8305085,Buy,5
25-03-2024 15:15,183,184,183,184,14,182.8803419,Buy,1
25-03-2024 15:00,182,182,182,182,2,182.7864078,Sell,0
25-03-2024 14:45,183,183,183,183,1,182.8019802,Sell,0
25-03-2024 14:30,184,184,181,181,2,182.8,Sell,3
25-03-2024 14:15,182,182,182,182,1,182.8061224,Sell,0
25-03-2024 14:00,183,183,183,183,2,182.814433,Sell,0
25-03-2024 13:45,183,183,183,183,3,182.8105263,Sell,0
25-03-2024 13:30,183,184,183,184,7,182.8043478,Buy,1
25-03-2024 13:15,181,185,181,183,57,182.7176471,Buy,4
25-03-2024 13:00,182,183,180,182,28,182.1071429,Sell,3
25-03-2024 09:45,182,184,181,184,104,174.1160542,Buy,3
25-03-2024 09:30,179,180,179,180,90,173.1677419,Buy,1
25-03-2024 09:15,179,179,179,179,1,172.5309524,Sell,0
25-03-2024 09:00,179,179,178,179,34,172.523242,Sell,1
25-03-2024 08:45,181,182,178,178,79,172.2770186,Sell,4
25-03-2024 08:30,180,183,176,181,122,171.4862259,Buy,7
25-03-2024 08:15,179,183,179,180,61,169.9304636,Buy,4
25-03-2024 08:00,177,179,177,179,15,168.7292818,Buy,2
25-03-2024 07:45,174,176,174,176,10,168.4772727,Buy,2
25-03-2024 07:30,173,177,173,175,42,168.3359073,Buy,4
25-03-2024 07:00,171,174,171,174,16,167.7563025,Buy,3
25-03-2024 06:45,172,172,168,168,27,167.5608696,Sell,4
25-03-2024 06:30,173,174,169,172,37,167.3810624,Sell,5
25-03-2024 04:15,173,173,172,172,11,166.969697,Sell,1
25-03-2024 04:00,172,173,172,173,22,166.8077922,Buy,1
25-03-2024 03:45,172,172,172,172,16,166.4683196,Sell,0
25-03-2024 03:30,169,172,169,170,57,166.2132565,Buy,3
25-03-2024 03:15,170,173,168,170,78,165.1896552,Sell,5
25-03-2024 03:00,167,167,164,166,51,163.0283019,Sell,3
25-03-2024 02:45,162,169,162,165,86,162.3913043,Buy,7
25-03-2024 02:30,163,163,155,162,75,158.8,Sell,8
22-03-2024 09:45,162,163,161,162,33,160.2335558,Sell,2
22-03-2024 09:30,162,162,162,162,25,160.1584646,Sell,0
22-03-2024 09:15,161,162,161,162,8,160.1120081,Buy,1
22-03-2024 09:00,159,162,159,161,34,160.1007121,Buy,3
22-03-2024 08:45,159,159,155,158,120,160.0716544,Sell,4
22-03-2024 08:30,164,164,160,160,15,160.5343788,Sell,4
22-03-2024 08:15,163,165,163,165,14,160.509828,Buy,2
22-03-2024 08:00,159,163,156,163,125,160.4525,Buy,7
22-03-2024 07:45,160,162,160,162,52,160.5496296,Buy,2
22-03-2024 07:30,158,160,158,159,35,160.5040128,Buy,2
22-03-2024 07:15,158,160,158,160,9,160.5493197,Buy,2
22-03-2024 07:00,159,161,158,158,43,160.5716753,Sell,3
22-03-2024 06:45,155,155,155,155,10,160.6175373,Sell,0
22-03-2024 06:30,157,160,154,154,39,160.7243346,Sell,6
22-03-2024 04:15,158,160,158,160,7,160.9609856,Buy,2
22-03-2024 04:00,159,159,158,158,3,160.9833333,Sell,1
22-03-2024 03:45,158,159,158,159,51,160.9979036,Buy,1
22-03-2024 03:30,158,158,157,157,2,161.3286385,Sell,1
22-03-2024 03:15,164,164,155,156,171,161.3466981,Sell,9
22-03-2024 03:00,163,166,162,166,38,163.6916996,Buy,4
22-03-2024 02:45,158,162,158,162,16,163.6232558,Buy,4
22-03-2024 02:30,159,160,152,154,47,163.9899497,Sell,8
21-03-2024 15:15,163,163,161,161,32,166.0921053,Sell,2
21-03-2024 15:00,162,162,162,162,3,167.3,Sell,0
21-03-2024 14:45,165,165,162,162,19,167.4358974,Sell,3
21-03-2024 14:30,165,166,165,165,6,168.4489796,Sell,1
21-03-2024 14:15,169,169,165,166,47,168.6630435,Sell,4
21-03-2024 14:00,172,172,169,169,7,171.0222222,Sell,3
21-03-2024 13:30,170,173,170,173,3,171.1315789,Buy,3
21-03-2024 13:15,170,173,170,173,27,171.0857143,Buy,3
21-03-2024 13:00,169,169,167,169,8,168.25,Sell,2
21-03-2024 09:45,170,173,170,171,139,168.8514931,Buy,3
21-03-2024 09:30,169,171,169,170,28,168.5981818,Buy,2
21-03-2024 09:15,168,168,168,168,3,168.5625,Sell,0
21-03-2024 08:30,166,166,166,166,15,168.5640786,Sell,0
21-03-2024 08:15,163,164,163,164,28,168.6005693,Buy,1
21-03-2024 08:00,163,163,163,163,3,168.7300195,Sell,0
21-03-2024 07:45,162,163,161,163,3,168.7468231,Buy,2
21-03-2024 07:30,163,163,162,162,12,168.7666667,Sell,1
21-03-2024 07:15,163,163,162,162,23,168.8462302,Sell,1
21-03-2024 07:00,163,164,162,163,39,168.9837563,Sell,2
21-03-2024 06:45,165,169,162,162,75,169.2505285,Sell,7
21-03-2024 06:30,177,177,160,162,463,169.4822044,Sell,17
21-03-2024 04:15,177,177,177,177,3,174.4240196,Sell,0
21-03-2024 04:00,177,177,177,177,2,174.4049383,Sell,0
21-03-2024 03:45,175,177,174,177,17,174.3920596,Buy,3
21-03-2024 03:15,174,176,174,176,20,174.3471503,Buy,2
21-03-2024 03:00,172,173,171,173,30,174.3251366,Buy,2
21-03-2024 02:45,171,174,171,171,73,174.5,Sell,3
21-03-2024 02:30,176,178,170,170,168,175.0912548,Sell,8
20-03-2024 15:15,179,179,177,177,3,177.4315789,Sell,2
20-03-2024 15:00,180,180,178,178,8,177.4021739,Sell,2
20-03-2024 14:45,176,180,176,179,37,177.2261905,Buy,4
20-03-2024 14:30,180,180,176,176,27,176.8085106,Sell,4
20-03-2024 14:15,178,178,178,178,8,177.45,Sell,0
20-03-2024 14:00,177,178,177,178,4,177.0833333,Buy,1
20-03-2024 13:15,175,177,175,177,3,176.75,Buy,2
20-03-2024 13:00,179,179,176,176,5,177.4,Sell,3
20-03-2024 09:45,172,178,172,178,99,167.0062696,Buy,6
20-03-2024 09:30,171,173,171,171,23,166.2141037,Sell,2
20-03-2024 09:15,170,171,167,171,89,166.0840555,Buy,4
20-03-2024 09:00,170,172,169,169,9,165.9492958,Sell,3
20-03-2024 08:45,167,172,167,172,69,165.9034091,Buy,5
20-03-2024 08:30,168,169,167,167,21,165.6757852,Sell,2
20-03-2024 08:15,170,170,168,168,20,165.6438923,Sell,2
20-03-2024 08:00,168,170,166,169,29,165.5708245,Buy,4
20-03-2024 07:45,166,170,166,170,16,165.4830971,Buy,4
20-03-2024 07:30,166,167,165,165,26,165.4439512,Sell,2
20-03-2024 07:15,167,167,166,166,14,165.4457143,Sell,1
20-03-2024 07:00,170,170,167,167,52,165.42741,Sell,3
20-03-2024 06:45,173,174,172,172,89,165.2410383,Sell,2
20-03-2024 06:30,172,172,166,172,122,164.3013889,Sell,6
20-03-2024 04:15,167,170,165,170,65,163.1488294,Buy,5
20-03-2024 04:00,166,166,165,165,11,162.7035647,Sell,1
20-03-2024 03:45,166,168,166,166,19,162.6417625,Sell,2
20-03-2024 03:30,168,168,164,166,63,162.4930417,Sell,4
20-03-2024 03:15,169,172,169,169,62,162.0886364,Sell,3
20-03-2024 03:00,162,173,162,170,109,160.7275132,Buy,11
20-03-2024 02:45,160,162,159,160,58,157.8550186,Sell,3
20-03-2024 02:30,155,160,155,158,114,157.0805687,Buy,5
19-03-2024 15:00,159,159,159,159,1,156.1958763,Sell,0
19-03-2024 14:45,157,160,157,160,28,156.1666667,Buy,3
19-03-2024 14:15,154,156,154,154,26,155.5588235,Sell,2
19-03-2024 13:30,156,157,155,157,28,156.0714286,Buy,2
19-03-2024 13:15,155,156,155,156,12,155.7142857,Buy,1
19-03-2024 13:00,155,155,154,154,2,154.5,Sell,1
19-03-2024 09:45,155,156,153,154,123,154.7888687,Sell,3
19-03-2024 09:30,155,155,155,155,4,154.7908497,Sell,0
19-03-2024 09:15,155,155,154,155,44,154.7903014,Sell,1
19-03-2024 09:00,154,155,154,155,154,154.7847503,Buy,1
19-03-2024 08:45,152,153,150,153,120,154.8433735,Buy,3
19-03-2024 08:30,152,152,152,152,75,155.0620861,Sell,0
19-03-2024 08:15,151,151,150,150,63,155.2647838,Sell,1
19-03-2024 08:00,153,154,150,152,171,155.5719626,Sell,4
19-03-2024 07:45,154,155,152,155,122,156.3804227,Buy,3
19-03-2024 07:30,153,155,151,154,101,156.8223938,Buy,4
19-03-2024 07:15,150,153,150,151,35,157.2914201,Buy,3
19-03-2024 07:00,154,154,151,151,20,157.5522621,Sell,3
19-03-2024 06:45,153,154,152,153,32,157.7310789,Sell,2
19-03-2024 06:30,153,156,151,152,131,157.9779287,Sell,5
19-03-2024 04:15,153,153,151,151,37,159.2489083,Sell,2
19-03-2024 04:00,153,153,153,153,1,159.8171021,Sell,0
19-03-2024 03:45,155,155,153,154,25,159.8333333,Sell,2
19-03-2024 03:30,155,156,155,156,4,160.2151899,Buy,1
19-03-2024 03:15,155,156,153,153,96,160.2659847,Sell,3
19-03-2024 03:00,153,153,153,153,6,162.0135593,Sell,0
19-03-2024 02:45,156,157,151,151,98,162.200692,Sell,6
19-03-2024 02:30,165,166,156,156,73,166.7539267,Sell,10
18-03-2024 15:15,163,163,163,163,1,171.0423729,Sell,0
18-03-2024 15:00,163,163,163,163,2,171.1111111,Sell,0
18-03-2024 14:45,163,163,163,163,1,171.2521739,Sell,0
18-03-2024 14:15,166,166,165,166,23,171.3245614,Sell,1
18-03-2024 14:00,170,170,170,170,1,172.8901099,Sell,0
18-03-2024 13:45,170,170,170,170,1,172.9222222,Sell,0
18-03-2024 13:30,174,174,172,172,58,172.9550562,Sell,2
18-03-2024 13:15,174,175,174,174,24,174.2903226,Sell,1
18-03-2024 13:00,174,174,174,174,7,174,Sell,0
18-03-2024 09:45,173,173,172,172,3,178.8318182,Sell,1
18-03-2024 09:30,178,178,174,174,51,178.8764302,Sell,4
18-03-2024 09:15,178,178,178,178,1,179.3082902,Sell,0
18-03-2024 09:00,181,182,177,177,50,179.3116883,Sell,5
18-03-2024 08:45,181,182,181,182,34,179.0507463,Buy,1
18-03-2024 08:30,182,182,179,182,12,178.8106312,Sell,3
18-03-2024 08:15,184,184,182,182,8,178.7508651,Sell,2
18-03-2024 08:00,183,184,183,183,27,178.6156584,Sell,1
18-03-2024 07:45,179,185,179,185,49,178.0748031,Buy,6
18-03-2024 07:15,176,176,175,175,5,176.9560976,Sell,1
18-03-2024 07:00,174,176,174,176,17,176.99,Buy,2
18-03-2024 06:45,174,174,174,174,3,177.1639344,Sell,0
18-03-2024 06:30,175,175,174,174,14,177.2166667,Sell,1
18-03-2024 04:15,174,174,174,174,2,177.4759036,Sell,0
18-03-2024 03:30,170,175,170,174,20,177.5182927,Buy,5
18-03-2024 03:15,170,170,165,169,23,178.2569444,Sell,5
18-03-2024 03:00,178,178,171,173,13,180.0495868,Sell,7
18-03-2024 02:45,179,179,174,178,67,180.7777778,Sell,5
18-03-2024 02:30,193,197,181,181,41,188.6097561,Sell,16
15-03-2024 09:45,189,191,186,188,68,193.1907216,Sell,5
15-03-2024 09:30,187,187,187,187,5,193.971875,Sell,0
15-03-2024 09:15,188,188,187,187,12,194.0825397,Sell,1
15-03-2024 09:00,189,189,188,188,10,194.3465347,Sell,1
15-03-2024 08:45,189,189,189,189,1,194.5494881,Sell,0
15-03-2024 08:30,190,190,189,189,11,194.5684932,Sell,1
15-03-2024 08:15,191,191,189,189,3,194.7580071,Sell,2
15-03-2024 08:00,190,193,190,193,11,194.8093525,Buy,3
15-03-2024 07:45,194,194,192,192,12,194.9475655,Sell,2
15-03-2024 07:30,191,194,191,194,10,195.0235294,Buy,3
15-03-2024 07:15,189,191,189,191,65,195.1428571,Buy,2
15-03-2024 07:00,188,188,188,188,2,196.8277778,Sell,0
15-03-2024 06:45,192,192,190,190,9,196.9269663,Sell,2
15-03-2024 04:15,193,193,193,193,11,197.2840237,Sell,0
15-03-2024 03:45,192,192,192,192,1,197.5822785,Sell,0
15-03-2024 03:15,193,193,193,193,1,197.6178344,Sell,0
15-03-2024 03:00,196,196,196,196,1,197.6474359,Sell,0
15-03-2024 02:45,197,198,195,197,34,197.6580645,Sell,3
15-03-2024 02:30,196,199,194,196,46,197.7520661,Sell,5
14-03-2024 14:15,200,200,199,199,4,198.24,Sell,1
14-03-2024 14:00,200,200,200,200,40,198.1690141,Sell,0
14-03-2024 13:45,195,198,195,198,20,195.8064516,Buy,3
14-03-2024 13:30,194,194,194,194,1,193.5454545,Sell,0
14-03-2024 13:00,193,194,193,194,10,193.5,Buy,1
14-03-2024 09:45,191,193,191,193,8,189.5379427,Buy,2
14-03-2024 09:30,192,192,189,190,13,189.5145299,Sell,3
14-03-2024 09:15,194,194,193,194,8,189.4807692,Sell,1
14-03-2024 09:00,193,195,193,193,8,189.4184397,Sell,2
14-03-2024 08:45,188,190,188,190,16,189.3597122,Buy,2
14-03-2024 08:30,188,192,186,192,8,189.3796296,Buy,6
14-03-2024 08:00,191,194,191,193,10,189.3740602,Buy,3
14-03-2024 07:45,193,195,192,193,13,189.3084291,Sell,3
14-03-2024 07:30,195,195,195,195,34,189.1827112,Sell,0
14-03-2024 07:15,197,197,197,197,1,188.7663158,Sell,0
14-03-2024 07:00,195,197,194,196,35,188.7489451,Buy,3
14-03-2024 06:45,195,198,192,196,49,188.2186788,Buy,6
14-03-2024 06:30,181,194,181,194,56,187.3153846,Buy,13
14-03-2024 04:15,181,181,179,179,2,186.494012,Sell,2
14-03-2024 04:00,179,179,176,176,12,186.5331325,Sell,3
14-03-2024 03:45,182,184,179,179,9,186.8875,Sell,5
14-03-2024 03:30,181,182,180,182,15,187.0321543,Buy,2
14-03-2024 03:15,190,190,179,179,91,187.3648649,Sell,11
14-03-2024 03:00,188,188,187,188,18,188.6731707,Sell,1
14-03-2024 02:45,195,197,189,189,45,188.7540107,Sell,8
14-03-2024 02:30,182,198,182,195,111,187.584507,Buy,16
13-03-2024 15:00,178,178,178,178,1,174.5483871,Sell,0
13-03-2024 14:45,176,176,176,176,1,174.4333333,Sell,0
13-03-2024 14:30,176,176,176,176,4,174.3793103,Sell,0
13-03-2024 14:15,178,178,178,178,1,174.12,Sell,0
13-03-2024 13:45,178,178,178,178,1,173.9583333,Sell,0
13-03-2024 13:30,177,177,177,177,3,173.7826087,Sell,0
13-03-2024 13:15,175,176,175,176,6,173.3,Buy,1
13-03-2024 13:00,173,173,172,172,14,172.2142857,Sell,1
13-03-2024 09:45,173,174,171,171,58,173.5449735,Sell,3
13-03-2024 09:30,170,172,170,172,29,173.5913556,Buy,2
13-03-2024 09:15,170,170,170,170,1,173.7104167,Sell,0
13-03-2024 09:00,168,170,168,170,28,173.7181628,Buy,2
13-03-2024 08:30,169,169,168,168,39,173.9800443,Sell,1
13-03-2024 08:15,168,169,168,168,26,174.4635922,Sell,1
13-03-2024 08:00,175,175,168,168,47,174.8367876,Sell,7
13-03-2024 07:45,172,172,172,172,7,175.560472,Sell,0
13-03-2024 07:30,174,176,174,176,9,175.6355422,Buy,2
13-03-2024 07:00,174,174,172,172,13,175.6439628,Sell,2
13-03-2024 06:45,175,175,172,172,13,175.7741935,Sell,3
13-03-2024 06:30,177,177,175,175,34,175.8888889,Sell,2
13-03-2024 04:15,176,176,175,176,31,175.9847909,Sell,1
13-03-2024 03:30,176,176,176,176,2,175.9956897,Sell,0
13-03-2024 03:00,170,170,169,170,3,175.9956522,Sell,1
13-03-2024 02:45,173,173,171,171,18,176.0792952,Sell,2
13-03-2024 02:30,177,183,173,173,144,176.3827751,Sell,10
12-03-2024 15:15,177,177,177,177,7,174.2461538,Sell,0
12-03-2024 15:00,179,179,179,179,1,173.9137931,Sell,0
12-03-2024 14:45,178,179,178,179,7,173.8245614,Buy,1
12-03-2024 14:00,174,175,174,175,4,173.22,Buy,1
12-03-2024 13:45,173,174,173,173,28,173.1086957,Sell,1
12-03-2024 13:30,173,175,173,173,11,173.2222222,Sell,2
12-03-2024 13:15,174,174,173,173,7,173.1428571,Sell,1
12-03-2024 09:45,175,176,173,175,32,182.1042553,Sell,3
12-03-2024 09:30,176,176,176,176,13,182.6484018,Sell,0
12-03-2024 09:00,177,177,176,176,34,182.8517647,Sell,1
12-03-2024 08:45,179,179,179,179,4,183.4015345,Sell,0
12-03-2024 08:30,182,183,179,179,5,183.4470284,Sell,4
12-03-2024 07:45,183,183,183,183,9,183.4712042,Sell,0
12-03-2024 07:30,182,185,182,185,14,183.4825737,Buy,3
12-03-2024 07:15,180,182,180,182,3,183.4818942,Buy,2
12-03-2024 07:00,182,182,179,179,16,183.502809,Sell,3
12-03-2024 06:45,179,181,179,181,10,183.6705882,Buy,2
12-03-2024 06:30,190,191,179,179,113,183.7636364,Sell,12
12-03-2024 04:15,191,191,189,189,10,182.1612903,Sell,2
12-03-2024 04:00,181,191,181,189,83,181.7729469,Buy,10
12-03-2024 03:45,180,181,180,181,21,179.2741935,Buy,1
12-03-2024 03:15,180,181,180,181,44,179.0194175,Buy,1
12-03-2024 03:00,181,182,181,182,9,177.8813559,Buy,1
12-03-2024 02:45,178,182,178,181,12,177.22,Buy,4
12-03-2024 02:30,174,178,173,178,23,176.3157895,Buy,5
11-03-2024 15:00,180,180,178,178,2,178.1333333,Sell,2
11-03-2024 14:45,180,180,178,178,3,178,Sell,2
11-03-2024 14:00,177,177,177,177,1,177.8,Sell,0
11-03-2024 13:15,180,180,178,178,3,177.8888889,Sell,2
11-03-2024 13:00,179,179,176,176,6,177.3333333,Sell,3
11-03-2024 09:45,173,183,169,183,269,171.3695381,Buy,14
11-03-2024 09:30,172,173,172,173,101,168.9116541,Buy,1
11-03-2024 09:15,170,172,170,172,13,168.0951276,Buy,2
11-03-2024 09:00,170,171,170,171,7,167.9904306,Buy,1
11-03-2024 08:45,169,169,169,169,1,167.9513382,Sell,0
11-03-2024 08:30,170,170,170,170,11,167.9487805,Sell,0
11-03-2024 08:15,170,171,170,170,14,167.8922306,Sell,1
11-03-2024 08:00,173,173,168,169,229,167.812987,Sell,5
11-03-2024 07:45,170,172,170,172,8,166.3461538,Buy,2
11-03-2024 07:30,169,169,169,169,2,166.1081081,Sell,0
11-03-2024 07:15,169,170,169,170,7,166.0684932,Buy,1
11-03-2024 07:00,166,167,166,167,13,165.8776978,Buy,1
11-03-2024 06:45,166,168,166,166,28,165.7698413,Sell,2
11-03-2024 06:30,168,168,159,164,49,165.5102041,Sell,9
11-03-2024 04:15,168,168,168,168,2,168.1020408,Sell,0
11-03-2024 03:30,168,168,168,168,1,168.106383,Sell,0
11-03-2024 03:15,167,167,165,166,9,168.1086957,Sell,2
11-03-2024 02:45,166,166,166,166,2,168.5675676,Sell,0
11-03-2024 02:30,183,183,164,165,35,168.7142857,Sell,19
08-03-2024 09:45,187,188,182,182,28,177.2506667,Sell,6
08-03-2024 09:30,185,185,184,185,3,176.5331412,Sell,1
08-03-2024 09:15,185,185,185,185,15,176.4622093,Sell,0
08-03-2024 09:00,181,181,181,181,2,176.0729483,Sell,0
08-03-2024 08:45,184,184,184,184,3,176.0428135,Sell,0
08-03-2024 08:30,183,183,180,181,9,175.9691358,Sell,3
08-03-2024 08:15,180,183,180,183,2,175.8253968,Buy,3
08-03-2024 07:15,180,183,177,182,44,175.7891374,Buy,6
08-03-2024 07:00,180,180,180,180,1,175.1115242,Sell,0
08-03-2024 06:45,181,181,177,181,73,175.0932836,Sell,4
08-03-2024 06:30,175,181,175,181,10,173.1487179,Buy,6
08-03-2024 04:15,175,175,175,175,21,172.8864865,Sell,0
08-03-2024 04:00,176,176,176,176,1,172.6158537,Sell,0
08-03-2024 03:45,178,178,178,178,2,172.595092,Sell,0
08-03-2024 03:30,177,177,175,177,6,172.5279503,Sell,2
08-03-2024 03:15,172,177,172,177,12,172.3677419,Buy,5
08-03-2024 03:00,169,172,169,170,21,172.0769231,Buy,3
08-03-2024 02:45,176,176,169,169,29,172.3688525,Sell,7
08-03-2024 02:30,175,178,173,176,43,172.6344086,Buy,5
07-03-2024 14:00,170,170,170,170,1,169.74,Sell,0
07-03-2024 13:45,168,169,167,169,30,169.7346939,Buy,2
07-03-2024 13:30,169,169,169,169,1,173.5263158,Sell,0
07-03-2024 13:00,176,177,173,173,18,173.7777778,Sell,4
07-03-2024 09:45,170,175,170,172,19,161.4744186,Buy,5
07-03-2024 09:30,170,170,170,170,2,160.4897959,Sell,0
07-03-2024 09:15,169,171,169,171,2,160.3917526,Buy,2
07-03-2024 08:15,162,166,162,166,44,160.2916667,Buy,4
07-03-2024 08:00,162,162,161,162,5,158.9256757,Sell,1
07-03-2024 07:30,160,160,160,160,13,158.8251748,Sell,0
07-03-2024 07:15,161,161,161,161,4,158.7076923,Sell,0
07-03-2024 06:45,160,160,160,160,7,158.6349206,Sell,0
07-03-2024 04:15,156,158,156,158,5,158.5546218,Buy,2
07-03-2024 03:45,153,155,153,155,9,158.6140351,Buy,2
07-03-2024 03:30,154,154,153,153,9,159.0380952,Sell,1
07-03-2024 03:15,155,155,154,154,21,159.5520833,Sell,1
07-03-2024 03:00,158,158,156,156,8,160.9733333,Sell,2
07-03-2024 02:45,160,161,160,161,24,161.4626866,Buy,1
07-03-2024 02:30,160,161,160,161,6,161.8372093,Buy,1
06-03-2024 15:00,160,160,160,160,8,162.027027,Sell,0
06-03-2024 14:30,164,164,161,162,4,162.5862069,Sell,3
06-03-2024 14:15,163,163,163,163,2,162.64,Sell,0
06-03-2024 14:00,160,161,160,161,9,162.6086957,Buy,1
06-03-2024 13:30,161,161,161,161,2,163.7142857,Sell,0
06-03-2024 13:15,164,164,163,163,10,164.1666667,Sell,1
06-03-2024 13:00,168,168,168,168,2,168,Sell,0
06-03-2024 09:45,163,167,163,167,120,157.3341772,Buy,4
06-03-2024 09:30,162,164,162,164,4,154.1345455,Buy,2
06-03-2024 09:00,162,162,162,162,1,154.00369,Sell,0
06-03-2024 08:30,163,163,163,163,1,153.9740741,Sell,0
06-03-2024 08:15,164,164,164,164,3,153.9405204,Sell,0
06-03-2024 08:00,159,166,159,166,40,153.8270677,Buy,7
06-03-2024 07:45,160,160,160,160,4,152.1238938,Sell,0
06-03-2024 07:15,155,156,155,155,18,151.981982,Sell,1
06-03-2024 07:00,155,155,155,155,1,151.6519608,Sell,0
06-03-2024 06:30,155,155,155,155,5,151.635468,Sell,0
06-03-2024 04:15,154,154,154,154,7,151.5505051,Sell,0
06-03-2024 03:30,155,155,155,155,8,151.460733,Sell,0
06-03-2024 03:15,153,154,153,154,26,151.3060109,Buy,1
06-03-2024 03:00,154,154,152,152,10,150.9681529,Sell,2
06-03-2024 02:45,152,154,152,154,29,150.8707483,Buy,2
06-03-2024 02:30,148,155,148,153,61,150.4322034,Buy,7
05-03-2024 15:15,147,147,147,147,1,148.1754386,Sell,0
05-03-2024 15:00,148,150,148,150,37,148.1964286,Buy,2
05-03-2024 14:30,146,147,146,147,9,146.5789474,Buy,1
05-03-2024 13:30,147,148,147,147,8,147,Sell,1
05-03-2024 13:15,146,146,146,146,1,146.5,Sell,0
05-03-2024 13:00,147,147,147,147,1,147,Sell,0
05-03-2024 09:45,147,148,146,148,7,139.3349515,Buy,2
05-03-2024 09:30,148,148,145,146,22,139.0603015,Sell,3
05-03-2024 09:15,147,147,145,147,9,138.0960452,Sell,2
05-03-2024 09:00,146,147,146,147,16,137.6428571,Buy,1
05-03-2024 08:45,146,146,146,146,1,136.7368421,Sell,0
05-03-2024 08:30,146,146,145,145,3,136.6754967,Sell,1
05-03-2024 08:15,145,145,145,145,7,136.4932432,Sell,0
05-03-2024 07:30,142,143,142,143,28,136.070922,Buy,1
05-03-2024 07:15,141,141,141,141,9,134.3716814,Sell,0
05-03-2024 07:00,141,141,141,141,1,133.7980769,Sell,0
05-03-2024 06:45,139,141,139,141,4,133.7281553,Buy,2
05-03-2024 06:30,141,143,140,140,11,133.4545455,Sell,3
05-03-2024 04:15,140,141,140,141,5,132.4090909,Buy,1
05-03-2024 04:00,138,139,138,139,5,131.9277108,Buy,1
05-03-2024 03:45,138,139,138,139,4,131.4871795,Buy,1
05-03-2024 03:30,136,136,136,136,6,131.1081081,Sell,0
05-03-2024 03:00,133,134,133,134,10,130.6764706,Buy,1
05-03-2024 02:45,128,133,128,133,22,130.2241379,Buy,5
05-03-2024 02:30,131,133,130,132,14,130.3055556,Buy,3
04-03-2024 15:15,130,130,130,130,1,129.6818182,Sell,0
04-03-2024 15:00,130,130,130,130,1,129.6666667,Sell,0
04-03-2024 14:30,131,131,131,131,2,129.65,Sell,0
04-03-2024 13:30,127,127,127,127,6,129.5,Sell,0
04-03-2024 13:15,128,128,128,128,2,130.75,Sell,0
04-03-2024 13:00,134,134,129,129,10,131.3,Sell,5
04-03-2024 09:45,131,131,129,129,6,131.0212766,Sell,2
04-03-2024 09:30,132,132,132,132,5,131.0909091,Sell,0
04-03-2024 09:15,132,133,132,132,4,131.0361446,Sell,1
04-03-2024 09:00,131,131,130,130,12,130.9620253,Sell,1
04-03-2024 08:30,134,134,134,134,2,131.1044776,Sell,0
04-03-2024 08:15,131,133,131,133,21,131.0153846,Buy,2
04-03-2024 07:45,131,131,131,131,2,130.2954545,Sell,0
04-03-2024 07:15,133,133,133,133,1,130.2619048,Sell,0
04-03-2024 04:00,134,134,134,134,3,130.195122,Sell,0
04-03-2024 03:45,133,133,133,133,1,129.8947368,Sell,0
04-03-2024 03:15,133,133,133,133,2,129.8108108,Sell,0
04-03-2024 03:00,131,132,131,132,14,129.6285714,Buy,1
04-03-2024 02:45,129,130,129,130,13,128.4761905,Buy,1
04-03-2024 02:30,128,128,125,125,8,127,Sell,3
01-03-2024 09:45,127,128,126,126,29,125.9264706,Sell,2
01-03-2024 09:30,128,128,127,128,8,125.76,Sell,1
01-03-2024 09:15,126,127,125,126,25,125.6826347,Sell,2
01-03-2024 09:00,126,126,126,126,13,125.6408451,Sell,0
01-03-2024 08:30,128,128,126,126,23,125.6046512,Sell,2
01-03-2024 08:15,130,130,129,129,6,125.245283,Sell,1
01-03-2024 08:00,130,130,130,130,8,125.01,Sell,0
01-03-2024 07:45,129,130,129,130,3,124.576087,Buy,1
01-03-2024 07:30,129,129,128,128,5,124.4157303,Sell,1
01-03-2024 07:15,130,130,129,130,7,124.1666667,Sell,1
01-03-2024 07:00,128,130,128,130,14,123.6493506,Buy,2
01-03-2024 06:45,126,128,126,128,8,122.2698413,Buy,2
01-03-2024 06:30,126,126,126,126,2,121.6363636,Sell,0
01-03-2024 04:15,124,124,124,124,5,121.4716981,Sell,0
01-03-2024 03:45,122,122,122,122,1,121.2083333,Sell,0
01-03-2024 03:30,121,122,121,122,3,121.1914894,Buy,1
01-03-2024 03:15,122,122,119,119,19,121.1590909,Sell,3
01-03-2024 03:00,123,123,123,123,1,121.32,Sell,0
01-03-2024 02:45,126,126,122,122,5,121.25,Sell,4
01-03-2024 02:30,122,122,122,122,5,120.2105263,Sell,0
29-02-2024 14:45,120,120,120,120,1,119.5714286,Sell,0
29-02-2024 14:30,120,120,118,120,10,119.5384615,Sell,2
29-02-2024 13:15,122,122,122,122,1,121.3333333,Sell,0
29-02-2024 13:00,121,121,121,121,2,121,Sell,0
29-02-2024 09:45,124,124,123,123,13,119.6697819,Sell,1
29-02-2024 09:30,121,124,121,124,55,119.4935065,Buy,3
29-02-2024 09:15,123,123,121,121,15,118.7075099,Sell,2
29-02-2024 09:00,122,123,122,123,14,118.5210084,Buy,1
29-02-2024 08:45,122,122,122,122,17,118.25,Sell,0
29-02-2024 08:30,120,121,120,121,19,117.942029,Buy,1
29-02-2024 08:15,120,121,117,119,22,117.6648936,Sell,4
29-02-2024 08:00,120,120,118,118,7,117.3674699,Sell,2
29-02-2024 07:45,118,120,118,120,17,117.3144654,Buy,2
29-02-2024 07:15,117,117,116,116,5,117.0070423,Sell,1
29-02-2024 07:00,117,117,117,117,6,117.0218978,Sell,0
29-02-2024 06:45,116,118,116,117,23,117.0229008,Buy,2
29-02-2024 06:30,117,118,117,117,8,117.0555556,Sell,1
29-02-2024 04:15,117,117,117,117,2,117.02,Sell,0
29-02-2024 04:00,116,117,116,117,7,117.0204082,Buy,1
29-02-2024 03:45,116,116,116,116,1,117.032967,Sell,0
29-02-2024 03:30,116,116,116,116,1,117.0444444,Sell,0
29-02-2024 03:15,116,117,116,116,7,117.0561798,Sell,1
29-02-2024 03:00,118,118,116,117,16,117.1219512,Sell,2
29-02-2024 02:45,118,120,118,120,10,117.1818182,Buy,2
29-02-2024 02:30,116,120,116,120,30,116.7142857,Buy,4
28-02-2024 15:15,115,115,115,115,2,114.9230769,Sell,0
28-02-2024 14:45,115,115,115,115,5,114.9166667,Sell,0
28-02-2024 14:30,115,115,115,115,15,114.8947368,Sell,0
28-02-2024 14:15,114,115,114,115,3,114.5,Buy,1
28-02-2024 13:45,114,114,114,114,1,114,Sell,0
28-02-2024 09:45,112,113,111,111,13,116.0846154,Sell,2
28-02-2024 09:30,113,113,113,113,2,116.5555556,Sell,0
28-02-2024 09:15,112,112,112,112,2,116.6173913,Sell,0
28-02-2024 08:30,110,111,110,111,8,116.699115,Buy,1
28-02-2024 08:15,112,112,111,111,10,117.152381,Sell,1
28-02-2024 08:00,114,114,112,112,3,117.7473684,Sell,2
28-02-2024 07:15,115,115,115,115,1,117.8913043,Sell,0
28-02-2024 07:00,117,117,116,116,3,117.9230769,Sell,1
28-02-2024 06:45,118,120,117,117,16,117.9659091,Sell,3
28-02-2024 06:30,115,117,115,117,5,117.9166667,Buy,2
28-02-2024 04:15,115,115,115,115,1,118.0149254,Sell,0
28-02-2024 03:15,118,118,115,115,2,118.0606061,Sell,3
28-02-2024 03:00,117,118,117,118,6,118.109375,Buy,1
28-02-2024 02:45,117,119,115,116,18,118.1551724,Sell,4
28-02-2024 02:30,120,122,117,117,19,118.7,Sell,5
27-02-2024 15:15,121,121,120,120,8,118.0952381,Sell,1
27-02-2024 14:45,121,121,121,121,1,116.5384615,Sell,0
27-02-2024 14:30,119,119,119,119,1,116.1666667,Sell,0
27-02-2024 14:00,116,116,116,116,1,115.9090909,Sell,0
27-02-2024 13:45,114,117,114,117,8,115.9,Buy,3
27-02-2024 13:30,114,116,114,116,2,115,Buy,2
27-02-2024 09:45,118,119,115,115,29,116.1691729,Sell,4
27-02-2024 09:30,121,121,119,119,18,116.0042194,Sell,2
27-02-2024 09:00,120,122,120,122,46,115.6621005,Buy,2
27-02-2024 08:45,116,119,116,119,6,114.4450867,Buy,3
27-02-2024 08:15,116,116,116,116,1,114.3592814,Sell,0
27-02-2024 07:45,115,115,115,115,5,114.3493976,Sell,0
27-02-2024 07:30,114,114,114,114,1,114.3291925,Sell,0
27-02-2024 07:15,114,115,114,115,12,114.33125,Buy,1
27-02-2024 06:45,109,114,109,114,43,114.3175676,Buy,5
27-02-2024 06:30,115,115,109,109,29,115.3047619,Sell,6
27-02-2024 04:15,114,114,114,114,2,116.6842105,Sell,0
27-02-2024 04:00,115,117,114,114,18,116.7567568,Sell,3
27-02-2024 03:45,115,115,115,115,1,117.25,Sell,0
27-02-2024 03:15,119,119,119,119,2,117.2909091,Sell,0
27-02-2024 02:30,119,119,116,119,30,117.2264151,Sell,3
26-02-2024 15:00,116,116,115,115,9,116.826087,Sell,1
26-02-2024 14:30,116,118,116,118,3,117.8571429,Buy,2
26-02-2024 14:00,118,119,118,119,3,118,Buy,1
26-02-2024 13:30,116,116,116,116,1,117.875,Sell,0
26-02-2024 13:15,118,120,118,119,4,118.1428571,Buy,2
26-02-2024 13:00,115,119,115,119,3,117,Buy,4
26-02-2024 09:45,117,117,115,115,7,115.0073529,Sell,2
26-02-2024 09:30,115,115,114,115,5,114.9767442,Sell,1
26-02-2024 09:15,115,116,115,115,12,114.9919355,Sell,1
26-02-2024 08:45,115,115,115,115,1,114.9107143,Sell,0
26-02-2024 08:30,113,113,113,113,1,114.9099099,Sell,0
26-02-2024 08:00,113,113,113,113,1,114.9272727,Sell,0
26-02-2024 07:30,115,115,115,115,1,114.9449541,Sell,0
26-02-2024 07:00,119,120,116,116,10,114.9444444,Sell,4
26-02-2024 06:45,116,121,116,118,37,114.622449,Buy,5
26-02-2024 06:30,115,116,115,116,30,111.2786885,Buy,1
26-02-2024 04:15,115,115,115,115,2,107.5806452,Sell,0
26-02-2024 02:45,110,111,110,110,4,107.0689655,Sell,1
26-02-2024 02:30,104,110,103,110,25,106.52,Buy,7
23-02-2024 09:45,110,110,110,110,3,106.047619,Sell,0
23-02-2024 09:30,110,110,110,110,1,105.85,Sell,0
23-02-2024 08:45,108,108,108,108,1,105.779661,Sell,0
23-02-2024 08:15,107,107,107,107,1,105.7413793,Sell,0
23-02-2024 03:00,105,107,104,107,23,105.7192982,Buy,3
23-02-2024 02:45,104,104,103,103,2,105.7352941,Sell,1
23-02-2024 02:30,103,105,103,105,13,105.875,Buy,2
22-02-2024 15:15,107,107,107,107,3,106.5789474,Sell,0
22-02-2024 15:00,107,107,107,107,1,106.5,Sell,0
22-02-2024 14:45,107,107,106,107,12,106.4666667,Sell,1
22-02-2024 14:30,107,107,107,107,2,107,Sell,0
22-02-2024 14:15,107,107,107,107,1,107,Sell,0
22-02-2024 09:45,108,108,108,108,2,107.9875,Sell,0
22-02-2024 09:30,108,108,107,107,2,107.9874477,Sell,1
22-02-2024 09:15,105,105,105,105,7,107.9894958,Sell,0
22-02-2024 08:30,107,107,105,105,44,108.0341151,Sell,2
22-02-2024 08:00,107,107,105,107,20,108.3294118,Sell,2
22-02-2024 07:45,107,107,106,107,68,108.4765432,Sell,1
22-02-2024 07:30,112,112,107,108,108,108.9050445,Sell,5
22-02-2024 07:00,114,115,110,110,59,109.1659389,Sell,5
22-02-2024 06:45,112,114,110,114,54,108.3352941,Buy,4
22-02-2024 06:30,112,112,112,112,1,107.2931034,Sell,0
22-02-2024 04:15,110,110,110,110,1,107.2521739,Sell,0
22-02-2024 04:00,110,112,110,112,4,107.2280702,Buy,2
22-02-2024 03:45,110,110,110,110,2,107.1090909,Sell,0
22-02-2024 03:15,110,110,110,110,2,107.0555556,Sell,0
22-02-2024 03:00,109,110,108,110,9,107,Buy,2
22-02-2024 02:30,107,107,107,107,1,106.7628866,Sell,0
21-02-2024 15:15,106,106,105,105,3,106.7604167,Sell,1
21-02-2024 14:30,109,109,106,106,3,106.7956989,Sell,3
21-02-2024 14:15,105,106,105,106,3,106.7888889,Buy,1
21-02-2024 13:15,107,107,106,106,3,106.8390805,Sell,1
21-02-2024 13:00,106,108,106,108,84,106.8452381,Buy,2
21-02-2024 09:45,106,109,106,109,188,106.8172867,Buy,3
21-02-2024 09:30,102,106,102,106,98,106.8016529,Buy,4
21-02-2024 09:15,104,104,103,104,29,106.9840764,Sell,1
21-02-2024 09:00,106,106,105,105,9,107.1402337,Sell,1
21-02-2024 08:45,107,108,106,106,49,107.1694915,Sell,2
21-02-2024 08:30,107,108,107,108,37,107.207024,Buy,1
21-02-2024 08:15,107,108,107,107,24,107.1944444,Sell,1
21-02-2024 08:00,108,110,107,108,46,107.1979167,Sell,3
21-02-2024 07:45,106,110,106,110,37,107.1290323,Buy,4
21-02-2024 07:30,109,109,108,109,21,107.0377834,Sell,1
21-02-2024 07:15,109,109,108,109,14,106.9308511,Sell,1
21-02-2024 07:00,112,112,108,108,56,106.8535912,Sell,4
21-02-2024 06:45,107,112,107,112,46,106.0359477,Buy,5
21-02-2024 06:30,105,106,105,106,12,105.4653846,Buy,1
21-02-2024 04:15,105,105,105,105,1,105.4435484,Sell,0
21-02-2024 04:00,105,105,105,105,2,105.4453441,Sell,0
21-02-2024 03:45,106,107,106,107,31,105.4489796,Buy,1
21-02-2024 03:30,106,106,106,106,28,105.3598131,Sell,0
21-02-2024 03:15,106,107,104,107,119,105.2634409,Buy,3
21-02-2024 03:00,105,106,105,106,24,103.8656716,Buy,1
21-02-2024 02:45,104,105,103,105,10,102.9767442,Buy,2
21-02-2024 02:30,103,104,102,104,5,102.7272727,Buy,2
20-02-2024 14:45,101,101,101,101,1,102.6428571,Sell,0
20-02-2024 14:30,103,103,103,103,1,102.7037037,Sell,0
20-02-2024 14:15,103,104,103,104,5,102.6923077,Buy,1
20-02-2024 14:00,103,103,103,103,7,102.5714286,Sell,0
20-02-2024 13:30,103,103,103,103,8,102.3571429,Sell,0
20-02-2024 13:00,102,102,101,101,6,101.5,Sell,1
20-02-2024 09:45,99,102,99,102,69,101.8852459,Buy,3
20-02-2024 09:30,101,101,101,101,1,102.9142857,Sell,0
20-02-2024 09:15,102,102,101,101,11,102.9252874,Sell,1
20-02-2024 08:45,101,101,101,101,2,103.0368098,Sell,0
20-02-2024 08:00,101,103,101,103,12,103.0621118,Buy,2
20-02-2024 07:30,102,102,101,102,12,103.147651,Sell,1
20-02-2024 07:15,104,104,102,102,24,103.2919708,Sell,2
20-02-2024 07:00,103,103,102,103,30,103.3097345,Sell,1
20-02-2024 06:45,106,106,103,103,15,103.6746988,Sell,3
20-02-2024 06:30,106,106,106,106,1,103.6323529,Sell,0
20-02-2024 03:45,104,104,104,104,2,103.5970149,Sell,0
20-02-2024 03:15,104,104,104,104,2,103.5846154,Sell,0
20-02-2024 02:45,104,104,102,103,16,103.5714286,Sell,2
20-02-2024 02:30,103,105,102,104,17,103.6382979,Buy,3
19-02-2024 15:15,102,102,102,102,1,103.5,Sell,0
19-02-2024 14:30,103,103,102,102,14,103.5517241,Sell,1
19-02-2024 14:00,106,106,106,106,3,104.5333333,Sell,0
19-02-2024 13:45,105,105,105,105,3,104.1666667,Sell,0
19-02-2024 13:30,105,105,105,105,4,103.8888889,Sell,0
19-02-2024 13:00,103,103,103,103,5,103,Sell,0
19-02-2024 09:45,103,106,103,105,31,102.6506024,Buy,3
19-02-2024 09:15,103,105,103,105,10,102.4186047,Buy,2
19-02-2024 09:00,104,104,103,103,19,102.3402062,Sell,1
19-02-2024 08:45,102,103,102,103,17,102.2757353,Buy,1
19-02-2024 08:30,103,104,103,104,3,102.2745098,Buy,1
19-02-2024 08:15,103,103,103,103,1,102.2619048,Sell,0
19-02-2024 07:30,101,101,101,101,1,102.2589641,Sell,0
19-02-2024 07:00,102,102,101,101,7,102.264,Sell,1
19-02-2024 06:45,102,102,102,102,6,102.2880658,Sell,0
19-02-2024 06:30,102,102,102,102,9,102.2953586,Sell,0
19-02-2024 03:45,101,101,101,101,2,102.3070175,Sell,0
19-02-2024 03:15,103,103,101,101,15,102.3185841,Sell,2
19-02-2024 02:45,102,104,101,102,41,102.3317536,Sell,3
19-02-2024 02:30,105,106,101,103,170,102.2705882,Sell,5
16-02-2024 09:45,102,103,101,102,18,103.4177215,Sell,2
16-02-2024 09:30,101,104,101,102,12,103.6214286,Buy,3
16-02-2024 09:15,102,102,101,101,2,103.8359375,Sell,1
16-02-2024 09:00,102,104,102,104,3,103.8730159,Buy,2
16-02-2024 08:00,101,101,101,101,2,103.8943089,Sell,0
16-02-2024 07:30,101,101,101,101,4,103.9421488,Sell,0
16-02-2024 07:15,104,104,101,101,10,104.042735,Sell,3
16-02-2024 06:30,107,107,105,105,3,104.1588785,Sell,2
16-02-2024 04:15,105,106,105,106,16,104.0961538,Buy,1
16-02-2024 04:00,104,105,104,105,12,103.8863636,Buy,1
16-02-2024 03:45,103,104,103,104,4,103.7236842,Buy,1
16-02-2024 03:30,102,104,102,103,4,103.7222222,Buy,2
16-02-2024 03:15,104,104,104,104,5,103.75,Sell,0
16-02-2024 03:00,104,104,103,103,4,103.7301587,Sell,1
16-02-2024 02:45,105,105,103,104,25,103.7457627,Sell,2
16-02-2024 02:30,103,105,102,105,22,103.7647059,Buy,3
15-02-2024 15:15,104,104,104,104,10,104.5833333,Sell,0
15-02-2024 15:00,106,106,106,106,1,107.5,Sell,0
15-02-2024 13:00,109,109,109,109,1,109,Sell,0
15-02-2024 09:45,107,107,107,107,1,111.4533333,Sell,0
15-02-2024 09:30,109,109,106,106,32,111.4732143,Sell,3
15-02-2024 09:00,111,111,111,111,1,112.2135417,Sell,0
15-02-2024 08:45,112,112,112,112,1,112.2198953,Sell,0
15-02-2024 08:30,109,110,109,110,5,112.2210526,Buy,1
15-02-2024 08:15,108,108,108,108,2,112.2864865,Sell,0
15-02-2024 08:00,111,111,111,111,4,112.3333333,Sell,0
15-02-2024 07:45,109,112,108,112,16,112.3631285,Buy,4
15-02-2024 07:30,111,115,111,115,2,112.6687117,Buy,4
15-02-2024 07:15,110,111,110,111,2,112.6645963,Buy,1
15-02-2024 07:00,112,112,112,112,2,112.6918239,Sell,0
15-02-2024 06:45,111,111,111,111,6,112.7006369,Sell,0
15-02-2024 06:30,110,110,108,108,2,112.7682119,Sell,2
15-02-2024 04:00,113,113,113,113,1,112.8187919,Sell,0
15-02-2024 03:15,111,111,111,111,23,112.8175676,Sell,0
15-02-2024 03:00,113,113,113,113,1,113.152,Sell,0
15-02-2024 02:45,113,113,112,112,21,113.1532258,Sell,1
15-02-2024 02:30,115,117,113,114,85,113.368932,Sell,4
14-02-2024 15:00,115,115,115,115,2,113.6111111,Sell,0
14-02-2024 14:45,115,115,115,115,2,113.4375,Sell,0
14-02-2024 14:30,115,115,112,115,10,113.2142857,Sell,3
14-02-2024 14:15,113,113,113,113,1,112.5,Sell,0
14-02-2024 14:00,112,113,112,113,3,112.3333333,Buy,1
14-02-2024 09:45,110,111,108,108,31,105.8146067,Sell,3
14-02-2024 09:30,107,108,107,108,13,105.4369231,Buy,1
14-02-2024 09:15,106,111,106,111,54,105.3653846,Buy,5
14-02-2024 08:00,106,106,106,106,31,104.4767442,Sell,0
14-02-2024 07:45,110,110,110,110,2,104.2687225,Sell,0
14-02-2024 07:30,110,110,110,110,1,104.2177778,Sell,0
14-02-2024 07:15,108,110,108,110,9,104.1919643,Buy,2
14-02-2024 07:00,108,110,108,110,36,103.9953488,Buy,2
14-02-2024 06:45,107,108,107,107,9,102.8826816,Sell,1
14-02-2024 06:30,105,106,101,104,88,102.6470588,Sell,5
14-02-2024 04:15,105,107,105,105,33,102.6707317,Sell,2
14-02-2024 03:30,104,104,104,104,8,100.9387755,Sell,0
14-02-2024 03:15,104,104,102,102,11,100.3414634,Sell,2
14-02-2024 03:00,104,104,104,104,1,99.63333333,Sell,0
14-02-2024 02:45,101,103,101,103,6,99.48275862,Buy,2
14-02-2024 02:30,100,102,99,101,13,98.86956522,Buy,3
13-02-2024 14:30,96,96,96,96,1,95.9,Sell,0
13-02-2024 13:45,96,96,96,96,2,95.88888889,Sell,0
13-02-2024 13:30,96,96,96,96,6,95.85714286,Sell,0
13-02-2024 13:15,95,95,95,95,1,95,Sell,0
13-02-2024 09:45,91,94,91,93,23,89.72972973,Buy,3
13-02-2024 08:30,89,89,89,89,2,86,Sell,0
13-02-2024 08:00,90,90,90,90,1,85.5,Sell,0
13-02-2024 07:30,92,92,92,92,2,85.09090909,Sell,0
13-02-2024 03:30,83,86,83,83,8,83.55555556,Sell,3
13-02-2024 03:15,83,83,83,83,1,83,Sell,0
09-02-2024 09:45,84,87,82,82,22,92.36413043,Sell,5
09-02-2024 08:30,82,82,80,80,9,93.40740741,Sell,2
09-02-2024 07:15,80,80,80,80,1,94.11111111,Sell,0
09-02-2024 06:45,86,86,86,86,4,94.20394737,Sell,0
09-02-2024 06:30,92,92,86,86,7,94.42567568,Sell,6
09-02-2024 04:15,94,95,93,93,31,94.79432624,Sell,2
09-02-2024 04:00,94,94,94,94,4,94.98181818,Sell,0
09-02-2024 03:45,94,94,94,94,1,95.01886792,Sell,0
09-02-2024 03:30,95,95,94,94,32,95.02857143,Sell,1
09-02-2024 03:15,97,97,95,95,16,95.46575342,Sell,2
09-02-2024 03:00,96,97,96,97,8,95.28070175,Buy,1
09-02-2024 02:45,101,101,99,99,5,95.08163265,Sell,2
09-02-2024 02:30,95,101,95,101,23,94.5,Buy,6
08-02-2024 15:00,92,93,92,93,19,91.95238095,Buy,1
08-02-2024 14:45,92,92,92,92,1,89.5,Sell,0
08-02-2024 14:30,87,87,87,87,1,87,Sell,0
08-02-2024 09:45,91,91,86,86,18,89.14285714,Sell,5
08-02-2024 09:15,94,94,94,94,1,89.18604651,Sell,0
08-02-2024 09:00,95,95,95,95,6,89.1484375,Sell,0
08-02-2024 08:45,97,97,97,97,3,88.86065574,Sell,0
08-02-2024 08:30,97,97,97,97,3,88.65546218,Sell,0
08-02-2024 08:15,98,98,98,98,11,88.43965517,Sell,0
08-02-2024 07:45,101,102,101,102,3,87.43809524,Buy,1
08-02-2024 07:30,99,100,99,100,2,87.01960784,Buy,1
08-02-2024 07:15,97,98,97,98,7,86.77,Buy,1
08-02-2024 07:00,93,95,93,95,4,85.94623656,Buy,2
08-02-2024 06:45,95,95,94,95,6,85.58426966,Sell,1
08-02-2024 06:30,95,97,95,97,7,84.91566265,Buy,2
08-02-2024 03:30,91,93,91,93,3,83.92105263,Buy,2
08-02-2024 03:15,94,95,92,92,9,83.60273973,Sell,3
08-02-2024 03:00,89,92,89,92,9,82.1875,Buy,3
08-02-2024 02:45,88,88,88,88,3,80.81818182,Sell,0
07-02-2024 15:00,79,79,79,79,1,80.40384615,Sell,0
07-02-2024 14:30,81,81,80,80,36,80.43137255,Sell,1
07-02-2024 13:30,81,81,80,80,12,80.66666667,Sell,1
07-02-2024 13:15,82,82,81,81,3,81.33333333,Sell,1
07-02-2024 09:45,82,82,80,80,8,80.10429448,Sell,2
07-02-2024 09:30,84,84,82,82,31,80.0516129,Sell,2
07-02-2024 09:00,83,83,83,83,1,79.19354839,Sell,0
07-02-2024 08:30,82,82,82,82,7,79.16260163,Sell,0
07-02-2024 08:15,84,84,82,82,15,78.99137931,Sell,2
07-02-2024 07:45,85,85,85,85,2,78.42574257,Sell,0
07-02-2024 07:30,84,85,84,85,5,78.29292929,Buy,1
07-02-2024 07:15,85,85,85,85,5,77.9787234,Sell,0
07-02-2024 07:00,82,85,82,85,12,77.58426966,Buy,3
07-02-2024 06:45,78,81,78,81,8,76.81818182,Buy,3
07-02-2024 04:15,76,76,76,76,1,76.49275362,Sell,0
07-02-2024 04:00,76,76,75,75,7,76.5,Sell,1
07-02-2024 03:45,76,76,76,76,4,76.59016393,Sell,0
07-02-2024 03:15,77,77,77,77,4,76.63157895,Sell,0
07-02-2024 03:00,75,75,75,75,3,76.60377358,Sell,0
07-02-2024 02:45,74,74,74,74,5,76.7,Sell,0
07-02-2024 02:30,79,79,74,74,31,77,Sell,5
06-02-2024 15:00,79,80,79,80,6,79.71428571,Buy,1
06-02-2024 14:45,79,79,79,79,1,80,Sell,0
06-02-2024 13:45,81,81,81,81,4,80.14285714,Sell,0
06-02-2024 13:15,79,79,79,79,3,79,Sell,0
06-02-2024 09:45,80,80,79,79,13,79.77659574,Sell,1
06-02-2024 09:30,80,82,80,82,18,79.77562028,Buy,2
06-02-2024 09:15,79,79,79,79,8,79.74587459,Sell,0
06-02-2024 09:00,80,80,78,79,29,79.75249723,Sell,2
06-02-2024 08:45,80,82,80,80,332,79.76376147,Sell,2
06-02-2024 08:30,80,80,78,78,8,79.23703704,Sell,2
06-02-2024 08:15,79,79,79,79,10,79.2518797,Sell,0
06-02-2024 08:00,80,82,80,80,140,79.25670498,Sell,2
06-02-2024 07:45,80,80,80,80,26,78.7513089,Sell,0
06-02-2024 07:15,79,80,79,80,18,78.66011236,Buy,1
06-02-2024 07:00,82,82,79,80,127,78.62721893,Sell,3
06-02-2024 06:45,74,83,74,83,150,77.40758294,Buy,9
06-02-2024 06:30,74,74,73,74,25,73.44262295,Sell,1
06-02-2024 03:00,75,75,75,75,2,73.44444444,Sell,0
06-02-2024 02:45,79,79,75,75,11,73.35294118,Sell,4
06-02-2024 02:30,76,79,76,79,5,71.95652174,Buy,3
05-02-2024 14:30,71,71,69,69,7,70.5,Sell,2
05-02-2024 14:15,72,72,72,72,1,71.09090909,Sell,0
05-02-2024 14:00,72,72,71,71,2,71,Sell,1
05-02-2024 13:45,71,71,71,71,2,70.875,Sell,0
05-02-2024 13:15,71,72,71,72,5,70.83333333,Buy,1
05-02-2024 13:00,69,69,69,69,1,69,Sell,0
05-02-2024 09:45,69,69,69,69,1,69.76190476,Sell,0
05-02-2024 09:15,70,70,70,70,9,69.768,Sell,0
05-02-2024 09:00,70,70,70,70,4,69.75,Sell,0
05-02-2024 08:45,73,73,70,70,6,69.74107143,Sell,3
05-02-2024 08:15,71,71,71,71,5,69.64150943,Sell,0
05-02-2024 08:00,71,74,71,74,9,69.57425743,Buy,3
05-02-2024 07:45,69,70,69,70,5,69.26086957,Buy,1
05-02-2024 07:30,68,68,68,68,21,69.22988506,Sell,0
05-02-2024 06:30,67,67,67,67,5,69.62121212,Sell,0
05-02-2024 04:15,69,69,69,69,1,69.83606557,Sell,0
05-02-2024 03:30,70,71,70,70,4,69.85,Sell,1
05-02-2024 03:15,70,70,70,70,5,69.82142857,Sell,0
05-02-2024 03:00,70,73,70,70,39,69.80392157,Sell,3
05-02-2024 02:45,68,68,68,68,3,68.83333333,Sell,0
05-02-2024 02:30,69,70,69,70,9,69.11111111,Buy,1
02-02-2024 09:45,67,67,66,66,14,71.5,Sell,1
02-02-2024 09:30,71,71,71,71,1,72.01449275,Sell,0
02-02-2024 09:00,70,70,70,70,2,72.02189781,Sell,0
02-02-2024 08:45,71,71,71,71,1,72.05185185,Sell,0
02-02-2024 08:30,71,71,71,71,1,72.05970149,Sell,0
02-02-2024 08:00,71,71,70,71,16,72.06766917,Sell,1
02-02-2024 07:45,72,72,72,72,7,72.29059829,Sell,0
02-02-2024 07:30,72,72,72,72,2,72.30909091,Sell,0
02-02-2024 07:15,72,72,72,72,8,72.31481481,Sell,0
02-02-2024 06:45,74,74,74,74,3,72.34,Sell,0
02-02-2024 06:30,74,74,74,74,2,72.28865979,Sell,0
02-02-2024 04:15,74,74,74,74,1,72.25263158,Sell,0
02-02-2024 03:45,75,75,75,75,2,72.23404255,Sell,0
02-02-2024 03:30,73,75,73,75,26,72.17391304,Buy,2
02-02-2024 03:15,74,74,74,74,5,71.45454545,Sell,0
02-02-2024 03:00,71,71,71,71,2,71.24590164,Sell,0
02-02-2024 02:45,71,76,71,72,43,71.25423729,Buy,5
02-02-2024 02:30,71,72,69,71,16,70.25,Sell,3
31-01-2024 09:45,73,77,73,77,23,80.04918033,Buy,4
31-01-2024 09:30,75,75,74,74,2,81.39393939,Sell,1
31-01-2024 09:00,76,76,76,76,4,81.53608247,Sell,0
31-01-2024 08:15,78,78,76,76,2,81.77419355,Sell,2
31-01-2024 07:45,80,80,79,79,12,81.87912088,Sell,1
31-01-2024 07:30,81,81,81,81,5,82.2278481,Sell,0
31-01-2024 06:45,81,82,81,82,9,82.31081081,Buy,1
31-01-2024 06:30,83,83,79,81,30,82.4,Sell,4
31-01-2024 04:15,86,86,86,86,7,83.77142857,Sell,0
31-01-2024 04:00,87,87,86,86,7,83.21428571,Sell,1
31-01-2024 03:30,87,87,87,87,1,82.14285714,Sell,0
31-01-2024 02:45,83,83,82,82,8,81.9,Sell,1
31-01-2024 02:30,81,81,81,81,1,81.5,Sell,0
30-01-2024 15:00,81,81,81,81,2,81.54545455,Sell,0
30-01-2024 14:00,82,82,82,82,3,81.66666667,Sell,0
30-01-2024 13:45,82,82,81,81,5,81.5,Sell,1
30-01-2024 13:00,82,82,82,82,1,82,Sell,0
30-01-2024 09:45,82,85,81,85,21,90.11278195,Buy,4
30-01-2024 08:45,84,84,84,84,2,90.4973545,Sell,0
30-01-2024 08:30,84,84,83,83,5,90.53191489,Sell,1
30-01-2024 07:30,85,85,85,85,4,90.63072776,Sell,0
30-01-2024 07:00,87,87,87,87,1,90.69209809,Sell,0
30-01-2024 06:45,87,87,86,86,2,90.70218579,Sell,1
30-01-2024 06:30,86,86,86,86,3,90.72527473,Sell,0
30-01-2024 04:15,88,88,83,84,155,90.76454294,Sell,5
30-01-2024 04:00,90,90,89,89,20,94.66990291,Sell,1
30-01-2024 03:15,91,92,90,91,38,95.23655914,Sell,2
30-01-2024 03:00,92,94,91,91,58,96.44594595,Sell,3
30-01-2024 02:45,98,98,92,92,33,99.15555556,Sell,6
30-01-2024 02:30,100,100,98,98,35,101.2982456,Sell,2
29-01-2024 14:45,103,104,103,104,13,104.3636364,Buy,1
29-01-2024 14:15,103,103,103,103,4,105.3333333,Sell,0
29-01-2024 13:15,107,108,107,108,4,107.2,Buy,1
29-01-2024 13:00,107,107,107,107,1,107,Sell,0
29-01-2024 09:45,103,104,103,103,10,107.9760479,Sell,1
29-01-2024 09:00,106,106,106,106,1,108.2866242,Sell,0
29-01-2024 08:45,106,106,106,106,3,108.3012821,Sell,0
29-01-2024 08:30,107,107,106,106,8,108.3464052,Sell,1
29-01-2024 08:00,106,106,106,106,2,108.4413793,Sell,0
29-01-2024 07:15,112,112,108,108,11,108.4755245,Sell,4
29-01-2024 07:00,112,112,112,112,9,108.3636364,Sell,0
29-01-2024 06:45,106,107,106,106,5,108.097561,Sell,1
29-01-2024 06:30,109,109,105,106,45,108.1779661,Sell,4
29-01-2024 04:00,107,107,107,107,1,109.7808219,Sell,0
29-01-2024 03:30,109,112,108,108,18,109.8194444,Sell,4
29-01-2024 03:15,108,109,107,109,16,109.462963,Buy,2
29-01-2024 03:00,112,112,108,108,27,110.2368421,Sell,4
29-01-2024 02:45,115,115,112,112,2,111.3636364,Sell,3
29-01-2024 02:30,110,112,110,111,9,110.8888889,Buy,2
26-01-2024 09:45,112,113,108,112,40,107.1111111,Sell,5
26-01-2024 09:30,109,112,109,112,9,105.9007634,Buy,3
26-01-2024 09:15,112,112,109,109,10,105.5081967,Sell,3
26-01-2024 09:00,110,112,110,111,16,105.1160714,Buy,2
26-01-2024 08:45,110,110,110,110,2,104.1666667,Sell,0
26-01-2024 08:30,110,110,110,110,1,104.0425532,Sell,0
26-01-2024 08:15,109,109,107,107,3,103.9784946,Sell,2
26-01-2024 08:00,109,110,109,110,9,103.8555556,Buy,1
26-01-2024 06:45,107,107,106,106,2,103.2098765,Sell,1
26-01-2024 06:30,108,108,107,107,3,103.1265823,Sell,1
26-01-2024 04:15,109,109,109,109,4,102.9605263,Sell,0
26-01-2024 04:00,108,108,108,108,1,102.625,Sell,0
26-01-2024 03:00,106,108,106,108,7,102.5492958,Buy,2
26-01-2024 02:45,103,104,103,104,13,102.078125,Buy,1
26-01-2024 02:30,104,104,100,102,51,101.6862745,Sell,4
24-01-2024 09:45,106,107,106,106,18,107.4934037,Sell,1
24-01-2024 09:30,109,109,109,109,2,107.5512465,Sell,0
24-01-2024 09:00,110,110,110,110,5,107.5431755,Sell,0
24-01-2024 08:45,109,110,109,110,3,107.5084746,Buy,1
24-01-2024 08:30,109,109,109,109,1,107.4928775,Sell,0
24-01-2024 07:45,105,105,105,105,1,107.4885714,Sell,0
24-01-2024 07:30,105,105,104,104,16,107.495702,Sell,1
24-01-2024 07:00,105,105,104,104,20,107.6606607,Sell,1
24-01-2024 06:30,107,109,103,107,54,107.8690096,Sell,6
24-01-2024 04:15,109,109,107,107,6,108.4594595,Sell,2
24-01-2024 03:45,109,109,109,109,1,108.4703557,Sell,0
24-01-2024 03:30,109,109,109,109,2,108.468254,Sell,0
24-01-2024 03:15,112,112,109,109,14,108.464,Sell,3
24-01-2024 03:00,111,112,111,111,28,108.3220339,Sell,1
24-01-2024 02:45,103,103,101,103,47,107.9471154,Sell,2
24-01-2024 02:30,111,113,104,104,120,109.7888199,Sell,9
23-01-2024 15:15,113,113,113,113,6,113.902439,Sell,0
23-01-2024 14:45,112,112,112,112,3,114.0571429,Sell,0
23-01-2024 14:30,113,113,113,113,7,114.25,Sell,0
23-01-2024 14:15,114,114,113,113,9,114.6,Sell,1
23-01-2024 14:00,115,115,115,115,2,115.125,Sell,0
23-01-2024 13:45,117,117,117,117,1,115.1428571,Sell,0
23-01-2024 13:15,115,115,115,115,13,115,Sell,0
23-01-2024 09:45,115,115,115,115,1,122.1780105,Sell,0
23-01-2024 09:30,116,116,116,116,20,122.2157895,Sell,0
23-01-2024 09:15,116,116,116,116,7,122.9470588,Sell,0
23-01-2024 09:00,118,118,117,118,15,123.2453988,Sell,1
23-01-2024 08:30,121,121,121,121,1,123.7837838,Sell,0
23-01-2024 07:15,120,120,120,120,1,123.8027211,Sell,0
23-01-2024 07:00,121,121,120,120,9,123.8287671,Sell,1
23-01-2024 06:30,123,123,122,123,21,124.0729927,Sell,1
23-01-2024 04:15,124,124,124,124,1,124.4137931,Sell,0
23-01-2024 03:15,127,127,127,127,1,124.4173913,Sell,0
23-01-2024 02:30,120,131,120,126,109,124.3947368,Buy,11
22-01-2024 15:00,120,120,120,120,1,120,Sell,0
22-01-2024 14:45,120,120,120,120,3,120,Sell,0
22-01-2024 14:15,120,120,120,120,1,120,Sell,0
22-01-2024 09:30,121,121,121,121,5,120.4411765,Sell,0
22-01-2024 09:15,123,123,122,122,8,120.4123711,Sell,1
22-01-2024 09:00,121,123,121,123,15,120.258427,Buy,2
22-01-2024 08:45,118,118,118,118,1,119.7972973,Sell,0
22-01-2024 08:15,120,122,119,122,17,119.8219178,Buy,3
22-01-2024 08:00,116,119,116,119,6,119.7142857,Buy,3
22-01-2024 07:00,116,116,116,116,1,119.9,Sell,0
22-01-2024 06:45,118,118,116,116,10,119.9795918,Sell,2
22-01-2024 06:30,118,118,118,118,2,120.8974359,Sell,0
22-01-2024 04:00,118,118,118,118,2,121.0540541,Sell,0
22-01-2024 03:00,119,119,119,119,3,121.2285714,Sell,0
22-01-2024 02:45,122,122,120,120,20,121.4375,Sell,2
22-01-2024 02:30,124,124,122,122,12,122.5833333,Sell,2
19-01-2024 09:45,123,127,123,126,23,123.5057034,Buy,4
19-01-2024 09:30,120,120,120,120,11,123.3291667,Sell,0
19-01-2024 09:15,122,122,122,122,3,123.489083,Sell,0
19-01-2024 08:45,120,120,120,120,4,123.5088496,Sell,0
19-01-2024 08:30,119,120,119,120,4,123.5720721,Buy,1
19-01-2024 08:15,120,121,120,121,8,123.646789,Buy,1
19-01-2024 08:00,123,124,121,121,38,123.7619048,Sell,3
19-01-2024 07:30,125,125,125,125,5,124.2383721,Sell,0
19-01-2024 07:15,125,125,123,123,5,124.2155689,Sell,2
19-01-2024 07:00,124,124,124,124,1,124.2160494,Sell,0
19-01-2024 06:45,125,125,125,125,1,124.2173913,Sell,0
19-01-2024 06:30,122,125,122,125,24,124.2125,Buy,3
19-01-2024 04:15,121,122,121,122,17,124.2279412,Buy,1
19-01-2024 04:00,120,121,119,119,18,124.5546218,Sell,2
19-01-2024 03:45,125,125,122,122,14,125.3861386,Sell,3
19-01-2024 03:30,124,124,124,124,10,125.7586207,Sell,0
19-01-2024 03:15,126,126,126,126,1,125.987013,Sell,0
19-01-2024 03:00,126,126,126,126,6,125.9868421,Sell,0
19-01-2024 02:45,126,126,125,125,4,125.9857143,Sell,1
19-01-2024 02:30,125,127,125,126,21,126.0151515,Buy,2
18-01-2024 15:15,127,127,125,125,39,126,Sell,2
18-01-2024 14:45,124,126,124,126,3,125.3333333,Buy,2
18-01-2024 14:15,125,125,125,125,1,126,Sell,0
18-01-2024 14:00,126,127,126,127,2,126.5,Buy,1
18-01-2024 09:45,114,127,114,127,100,117.9039548,Buy,13
18-01-2024 09:30,113,113,113,113,1,111.6103896,Sell,0
18-01-2024 09:15,116,116,114,114,4,111.5921053,Sell,2
18-01-2024 08:30,116,116,116,116,1,111.4027778,Sell,0
18-01-2024 07:45,115,115,115,115,2,111.3380282,Sell,0
18-01-2024 07:30,113,115,113,115,4,111.2318841,Buy,2
18-01-2024 07:15,114,114,114,114,1,111.0769231,Sell,0
18-01-2024 07:00,115,115,113,113,7,111.03125,Sell,2
18-01-2024 06:45,113,115,113,115,26,110.6140351,Buy,2
18-01-2024 06:30,109,113,109,113,10,107.6129032,Buy,4
18-01-2024 04:00,110,110,110,110,3,106.1428571,Sell,0
18-01-2024 03:45,110,110,110,110,2,105.5,Sell,0
18-01-2024 03:15,106,106,106,106,4,104.9375,Sell,0
18-01-2024 03:00,104,105,104,105,7,104.5833333,Buy,1
17-01-2024 15:00,105,105,105,105,1,104.4,Sell,0
17-01-2024 14:45,105,105,105,105,3,104.25,Sell,0
17-01-2024 13:30,102,102,102,102,1,102,Sell,0
17-01-2024 09:45,102,102,97,99,27,100.7575758,Sell,5
17-01-2024 09:30,100,100,100,100,1,102.5897436,Sell,0
17-01-2024 09:15,104,104,100,100,25,102.6578947,Sell,4
17-01-2024 09:00,105,106,104,105,5,105.1538462,Sell,2
17-01-2024 08:30,105,106,105,106,7,105.25,Buy,1
17-01-2024 07:45,102,102,102,102,1,102,Sell,0
